0 Name Name Name foreign unspecified unspecified unspecified unspecified unspecified  	O	null
1 : : : punctuation unspecified unspecified unspecified unspecified unspecified  	O	null
2 די די די quantifier unspecified unspecified construct unspecified unspecified  	O	null
3 - - - properName unspecified unspecified unspecified unspecified unspecified  	O	null
4 נור נור נור properName unspecified unspecified unspecified unspecified unspecified  	I_ORG	null
5 ( ( ( punctuation unspecified unspecified unspecified unspecified unspecified  	O	null
6 פיינר פיינר פיינר properName unspecified unspecified unspecified unspecified unspecified  	I_ORG	null
7 ) ) ) punctuation unspecified unspecified unspecified unspecified unspecified  	O	null
8 , , , punctuation unspecified unspecified unspecified unspecified unspecified  	O	null
9 יחיאל יחיאל יחיאל properName unspecified unspecified unspecified unspecified unspecified  	I_PERS	null
10 ( ( ( punctuation unspecified unspecified unspecified unspecified unspecified  	O	null
11 ק ק ק properName unspecified unspecified unspecified unspecified unspecified  	O	null
12 ' ' ' punctuation unspecified unspecified unspecified unspecified unspecified  	O	null
13 צטניק צטניק צטניק verb masculine singular unspecified 3 past  	O	null
14 ) ) ) punctuation unspecified unspecified unspecified unspecified unspecified  	O	null
15 Birth Birth Birth foreign unspecified unspecified unspecified unspecified unspecified  	O	null
16 Year Year Year foreign unspecified unspecified unspecified unspecified unspecified  	O	null
17 : : : punctuation unspecified unspecified unspecified unspecified unspecified  	O	null
18 ###NUMBER### ###NUMBER### ###NUMBER### numeral unspecified unspecified unspecified unspecified unspecified  	I_DATE	null
19 Death Death Death foreign unspecified unspecified unspecified unspecified unspecified  	O	null
20 Year Year Year foreign unspecified unspecified unspecified unspecified unspecified  	O	null
21 : : : punctuation unspecified unspecified unspecified unspecified unspecified  	O	null
22 ###NUMBER### ###NUMBER### ###NUMBER### numeral unspecified unspecified unspecified unspecified unspecified  	I_DATE	null
23 Birth Birth Birth foreign unspecified unspecified unspecified unspecified unspecified  	O	null
24 Place Place Place foreign unspecified unspecified unspecified unspecified unspecified  	O	null
25 : : : punctuation unspecified unspecified unspecified unspecified unspecified  	O	null
26 בסוסנוביץ בסוסנוביץ בסוסנוביץ properName unspecified unspecified unspecified unspecified unspecified  	I_ORG	null
27 , , , punctuation unspecified unspecified unspecified unspecified unspecified  	O	null
28 פולין פולין פולין properName unspecified unspecified unspecified unspecified unspecified  	I_LOC	null
29 , , , punctuation unspecified unspecified unspecified unspecified unspecified  	O	null
30 Occupation Occupation Occupation foreign unspecified unspecified unspecified unspecified unspecified  	O	null
31 : : : punctuation unspecified unspecified unspecified unspecified unspecified  	O	null
32 סופר ספר סופר participle masculine singular absolute any unspecified  	O	null
33 Entry Entry Entry foreign unspecified unspecified unspecified unspecified unspecified  	O	null
34 writer writer writer foreign unspecified unspecified unspecified unspecified unspecified  	O	null
35 : : : punctuation unspecified unspecified unspecified unspecified unspecified  	O	null
36 זהבה זהבה זהבה properName feminine singular unspecified unspecified unspecified  	I_PERS	null
37 כספי כסף כספי properName unspecified unspecified unspecified unspecified unspecified  	I_PERS	null
38 Entry Entry Entry foreign unspecified unspecified unspecified unspecified unspecified  	O	null
39 Value Value Value foreign unspecified unspecified unspecified unspecified unspecified  	O	null
40 : : : punctuation unspecified unspecified unspecified unspecified unspecified  	O	null
41 נולד נולד נולד verb masculine singular unspecified 3 past  	O	null
42 ב ב ב preposition unspecified unspecified unspecified unspecified unspecified 0 	I_ORG	null
43 - - - punctuation unspecified unspecified unspecified unspecified unspecified  	I_ORG	null
44 ###NUMBER### ###NUMBER### ###NUMBER### numeral unspecified unspecified unspecified unspecified unspecified  	I_DATE	null
45 בסוסנוביץ בסוסנוביץ בסוסנוביץ properName unspecified unspecified unspecified unspecified unspecified  	I_PERS	null
46 , , , punctuation unspecified unspecified unspecified unspecified unspecified  	O	null
47 פולין פולין פולין properName unspecified unspecified unspecified unspecified unspecified  	I_LOC	null
48 , , , punctuation unspecified unspecified unspecified unspecified unspecified  	O	null
49 ל ל למשפחה preposition unspecified unspecified unspecified unspecified unspecified 0 
49 ה ה למשפחה definiteArticle unspecified unspecified unspecified unspecified unspecified 0 
49 המשפחה משפחה למשפחה noun feminine singular absolute unspecified unspecified  	O	null
50 חסידית חסידי חסידית adjective feminine singular absolute unspecified unspecified  	O	null
51 . . . punctuation unspecified unspecified unspecified unspecified unspecified  	O	null

0 לפי לפי לפי preposition unspecified unspecified unspecified unspecified unspecified  	O	null
1 גרסה גרסה גרסה noun feminine singular absolute unspecified unspecified  	O	null
2 אחרת אחר אחרת adjective feminine singular absolute unspecified unspecified  	O	null
3 , , , punctuation unspecified unspecified unspecified unspecified unspecified  	O	null
4 נולד נולד נולד verb masculine singular unspecified 3 past  	O	null
5 כ כ כקרל preposition unspecified unspecified unspecified unspecified unspecified 0 
5 קרל קרל כקרל properName unspecified unspecified unspecified unspecified unspecified  	I_PERS	null
6 צטינסקי צטינסקי צטינסקי properName unspecified unspecified unspecified unspecified unspecified  	I_PERS	null
7 ב ב ב preposition unspecified unspecified unspecified unspecified unspecified 0 	I_ORG	null
8 - - - punctuation unspecified unspecified unspecified unspecified unspecified  	I_ORG	null
9 ###NUMBER### ###NUMBER### ###NUMBER### numeral unspecified unspecified unspecified unspecified unspecified  	I_DATE	null
10 ב ב בקטוביץ preposition unspecified unspecified unspecified unspecified unspecified 0 
10 קטוביץ קטוביץ בקטוביץ properName unspecified unspecified unspecified unspecified unspecified  	O	null
11 . . . punctuation unspecified unspecified unspecified unspecified unspecified  	O	null

0 כיום כיום כיום adverb unspecified unspecified unspecified unspecified unspecified  	O	null
1 , , , punctuation unspecified unspecified unspecified unspecified unspecified  	O	null
2 בעקבות בעקבות בעקבות preposition unspecified unspecified unspecified unspecified unspecified  	O	null
3 גילוי גילוי גילוי noun masculine singular construct unspecified unspecified  	O	null
4 תעודת תעודה תעודת noun feminine singular construct unspecified unspecified  	O	null
5 ה ה הלידה definiteArticle unspecified unspecified unspecified unspecified unspecified 0 
5 הלידה לידה הלידה noun feminine singular absolute unspecified unspecified  	O	null
6 של של שלו shel-preposition unspecified unspecified unspecified unspecified unspecified  
6 ו ו שלו pronomial masculine singular unspecified 3 unspecified 0 	O	null
7 ב ב בפולין preposition unspecified unspecified unspecified unspecified unspecified 0 
7 פולין פולין בפולין properName unspecified unspecified unspecified unspecified unspecified  	I_LOC	null
8 , , , punctuation unspecified unspecified unspecified unspecified unspecified  	O	null
9 ברור ברור ברור adjective masculine singular absolute unspecified unspecified  	O	null
10 ש ש שהגרסה relativizer/subordinatingConjunction unspecified unspecified unspecified unspecified unspecified 0 
10 ה ה שהגרסה definiteArticle unspecified unspecified unspecified unspecified unspecified 0 
10 הגרסה גרסה שהגרסה noun feminine singular absolute unspecified unspecified  	O	null
11 ה ה הראשונה definiteArticle unspecified unspecified unspecified unspecified unspecified 0 
11 הראשונה ORD1 הראשונה numeral feminine singular absolute unspecified unspecified  	O	null
12 היא הוא היא copula feminine singular unspecified 3 beinoni  	O	null
13 ה ה הנכונה definiteArticle unspecified unspecified unspecified unspecified unspecified 0 
13 הנכונה נכון הנכונה adjective feminine singular absolute unspecified unspecified  	O	null
14 , , , punctuation unspecified unspecified unspecified unspecified unspecified  	O	null
15 אך אך אך conjunction unspecified unspecified unspecified unspecified unspecified  	O	null
16 ה ה ההטעיה definiteArticle unspecified unspecified unspecified unspecified unspecified 0 
16 ההטעיה הטעיה ההטעיה noun feminine singular absolute unspecified unspecified  	O	null
17 ה ה המכוונת definiteArticle unspecified unspecified unspecified unspecified unspecified 0 
17 המכוונת מכוון המכוונת adjective feminine singular absolute unspecified unspecified  	O	null
18 ש ש שיצר relativizer/subordinatingConjunction unspecified unspecified unspecified unspecified unspecified 0 
18 יצר יצר שיצר verb masculine singular unspecified 3 past  	O	null
19 ק' ק' ק' preposition unspecified unspecified unspecified unspecified unspecified  	O	null
20 צטניק צטניק צטניק noun masculine singular absolute unspecified unspecified  	O	null
21 סביב סביב סביב preposition unspecified unspecified unspecified unspecified unspecified  	O	null
22 פרטי פרט פרטי noun masculine plural construct unspecified unspecified  	O	null
23 ה ה הזהות definiteArticle unspecified unspecified unspecified unspecified unspecified 0 
23 הזהות זהות הזהות noun feminine singular absolute unspecified unspecified  	O	null
24 ה ה הבסיסיים definiteArticle unspecified unspecified unspecified unspecified unspecified 0 
24 הבסיסיים בסיסי הבסיסיים adjective masculine plural absolute unspecified unspecified  	O	null
25 של של שלו shel-preposition unspecified unspecified unspecified unspecified unspecified  
25 ו ו שלו pronomial masculine singular unspecified 3 unspecified 0 	O	null
26 היא הוא היא copula feminine singular unspecified 3 beinoni  	O	null
27 חלק חלק חלק noun masculine singular absolute unspecified unspecified  	O	null
28 מ מ מהמסתורין preposition unspecified unspecified unspecified unspecified unspecified 0 
28 ה ה מהמסתורין definiteArticle unspecified unspecified unspecified unspecified unspecified 0 
28 המסתורין מסתורין מהמסתורין noun masculine singular absolute unspecified unspecified  	O	null
29 ש ש שאפף relativizer/subordinatingConjunction unspecified unspecified unspecified unspecified unspecified 0 
29 אפף אפף שאפף verb masculine singular unspecified 3 past  	O	null
30 את את את at-preposition unspecified unspecified unspecified unspecified unspecified  	O	null
31 דמות דמות דמותו noun feminine singular absolute unspecified unspecified  
31 ו ו דמותו possessive masculine singular unspecified 3 unspecified 0 	O	null
32 ה ה הבלתי definiteArticle unspecified unspecified unspecified unspecified unspecified 0 
32 הבלתי בלתי הבלתי wPrefix unspecified unspecified unspecified unspecified unspecified  	O	null
33 - - - punctuation unspecified unspecified unspecified unspecified unspecified  	O	null
34 מפוענחת פוענח מפוענחת participle feminine singular absolute any unspecified  	O	null
35 של של של shel-preposition unspecified unspecified unspecified unspecified unspecified  	O	null
36 ה ה האיש definiteArticle unspecified unspecified unspecified unspecified unspecified 0 
36 האיש איש האיש noun masculine singular absolute unspecified unspecified  	O	null
37 , , , punctuation unspecified unspecified unspecified unspecified unspecified  	O	null
38 ש ש שהטביע relativizer/subordinatingConjunction unspecified unspecified unspecified unspecified unspecified 0 
38 הטביע הטביע שהטביע verb masculine singular unspecified 3 past  	O	null
39 את את את at-preposition unspecified unspecified unspecified unspecified unspecified  	O	null
40 חותם חותם חותמו noun masculine singular absolute unspecified unspecified  
40 ו ו חותמו possessive masculine singular unspecified 3 unspecified 0 	O	null
41 על על על preposition unspecified unspecified unspecified unspecified unspecified  	O	null
42 ה ה האופן definiteArticle unspecified unspecified unspecified unspecified unspecified 0 
42 האופן אופן האופן noun masculine singular absolute unspecified unspecified  	O	null
43 שבו ישב שבו verb masculine-and-feminine plural unspecified 2 imperative  	O	null
44 תפשו תפש תפשו verb masculine-and-feminine plural unspecified 3 past  	O	null
45 ב ב בארץ preposition unspecified unspecified unspecified unspecified unspecified 0 
45 ה ה בארץ definiteArticle unspecified unspecified unspecified unspecified unspecified 0 
45 הארץ ארץ בארץ noun feminine singular absolute unspecified unspecified  	O	null
46 , , , punctuation unspecified unspecified unspecified unspecified unspecified  	O	null
47 ו ו ואף conjunction unspecified unspecified unspecified unspecified unspecified 0 
47 אף אף ואף conjunction unspecified unspecified unspecified unspecified unspecified  	O	null
48 ב ב בעולם preposition unspecified unspecified unspecified unspecified unspecified 0 
48 ה ה בעולם definiteArticle unspecified unspecified unspecified unspecified unspecified 0 
48 העולם עולם בעולם noun masculine singular absolute unspecified unspecified  	O	null
49 , , , punctuation unspecified unspecified unspecified unspecified unspecified  	O	null
50 את את את at-preposition unspecified unspecified unspecified unspecified unspecified  	O	null
51 ה ה השואה definiteArticle unspecified unspecified unspecified unspecified unspecified 0 
51 השואה שואה השואה noun feminine singular absolute unspecified unspecified  	O	null
52 ו ו ומוראותיה conjunction unspecified unspecified unspecified unspecified unspecified 0 
52 מוראותיה מוראותיה ומוראותיה noun feminine singular absolute unspecified unspecified  	O	null
53 במשך במשך במשך preposition unspecified unspecified unspecified unspecified unspecified  	O	null
54 שנים שנה שנים noun feminine plural absolute unspecified unspecified  	O	null
55 רבות רב רבות adjective feminine plural absolute unspecified unspecified  	O	null
56 . . . punctuation unspecified unspecified unspecified unspecified unspecified  	O	null

0 ב ב בנעוריו preposition unspecified unspecified unspecified unspecified unspecified 0 
0 נעורי נעורים בנעוריו noun masculine plural absolute unspecified unspecified  
0 ו ו בנעוריו possessive masculine singular unspecified 3 unspecified 0 	O	null
1 קיבל קיבל קיבל verb masculine singular unspecified 3 past  	O	null
2 השכלה השכלה השכלה noun feminine singular absolute unspecified unspecified  	O	null
3 תורנית תורן תורנית adjective feminine singular absolute unspecified unspecified  	O	null
4 ב ב בישיבת preposition unspecified unspecified unspecified unspecified unspecified 0 
4 ישיבת ישיבה בישיבת noun feminine singular construct unspecified unspecified  	I_ORG	null
5 " " " punctuation unspecified unspecified unspecified unspecified unspecified  	I_ORG	null
6 חכמי חכם חכמי noun masculine plural construct unspecified unspecified  	I_ORG	null
7 לובלין לובלין לובלין properName unspecified unspecified unspecified unspecified unspecified  	I_ORG	null
8 " " " punctuation unspecified unspecified unspecified unspecified unspecified  	O	null
9 ו ו ובמקביל conjunction unspecified unspecified unspecified unspecified unspecified 0 
9 במקביל במקביל ובמקביל adverb unspecified unspecified unspecified unspecified unspecified  	O	null
10 למד למד למד verb masculine singular unspecified 3 past  	O	null
11 כנראה כנראה כנראה adverb unspecified unspecified unspecified unspecified unspecified  	O	null
12 גם גם גם conjunction unspecified unspecified unspecified unspecified unspecified  	O	null
13 קבלה קבלה קבלה noun feminine singular absolute unspecified unspecified  	O	null
14 , , , punctuation unspecified unspecified unspecified unspecified unspecified  	O	null
15 ו ו והיה conjunction unspecified unspecified unspecified unspecified unspecified 0 
15 היה הוא והיה copula masculine singular unspecified 3 past  	O	null
16 עסקן עסקן עסקן noun masculine singular absolute unspecified unspecified  	O	null
17 של של של shel-preposition unspecified unspecified unspecified unspecified unspecified  	O	null
18 צעירי צעיר צעירי noun masculine plural construct unspecified unspecified  	O	null
19 " " " punctuation unspecified unspecified unspecified unspecified unspecified  	O	null
20 אגודת אגודה אגודת properName unspecified unspecified unspecified unspecified unspecified  	I_ORG	null
21 ישראל ישראל ישראל properName unspecified unspecified unspecified unspecified unspecified  	I_ORG	null
22 " " " punctuation unspecified unspecified unspecified unspecified unspecified  	O	null
23 . . . punctuation unspecified unspecified unspecified unspecified unspecified  	O	null

0 עוד עוד עוד adverb unspecified unspecified unspecified unspecified unspecified  	O	null
1 טרם טרם טרם adverb unspecified unspecified unspecified unspecified unspecified  	O	null
2 מלחמת מלחמה מלחמת noun feminine singular construct unspecified unspecified  	O	null
3 ה ה העולם definiteArticle unspecified unspecified unspecified unspecified unspecified 0 
3 העולם עולם העולם noun masculine singular absolute unspecified unspecified  	O	null
4 ה ה השנייה definiteArticle unspecified unspecified unspecified unspecified unspecified 0 
4 השנייה ORD2 השנייה numeral feminine singular absolute unspecified unspecified  	O	null
5 החל החל החל verb unspecified unspecified unspecified unspecified infinitive  	O	null
6 לפרסםשירה לפרסםשירה לפרסםשירה adjective feminine singular construct unspecified unspecified  	O	null
7 ב ב ביידיש preposition unspecified unspecified unspecified unspecified unspecified 0 
7 יידיש יידיש ביידיש properName feminine singular unspecified unspecified unspecified  	I_ORG	null
8 ו ו ובעברית conjunction unspecified unspecified unspecified unspecified unspecified 0 
8 ב ב ובעברית preposition unspecified unspecified unspecified unspecified unspecified 0 
8 ה ה ובעברית definiteArticle unspecified unspecified unspecified unspecified unspecified 0 
8 העברית עברית ובעברית properName feminine singular unspecified unspecified unspecified  	I_ORG	null
9 , , , punctuation unspecified unspecified unspecified unspecified unspecified  	O	null
10 ב ב בעיתון preposition unspecified unspecified unspecified unspecified unspecified 0 
10 ה ה בעיתון definiteArticle unspecified unspecified unspecified unspecified unspecified 0 
10 העיתון עיתון בעיתון noun masculine singular absolute unspecified unspecified  	O	null
11 ה ה הרוויזיוניסטי definiteArticle unspecified unspecified unspecified unspecified unspecified 0 
11 הרוויזיוניסטי הרוויזיוניסטי הרוויזיוניסטי adjective masculine singular absolute unspecified unspecified  	O	null
12 אונדזער אונדזער אונדזער properName unspecified unspecified unspecified unspecified unspecified  	I_LOC	null
13 טאנבלאט טאנבלאט טאנבלאט adverb unspecified unspecified unspecified unspecified unspecified  	O	null
14 ש ש שיצא relativizer/subordinatingConjunction unspecified unspecified unspecified unspecified unspecified 0 
14 יצא יצא שיצא verb masculine singular unspecified 3 past  	O	null
15 בסוסנוביץ בסוסנוביץ בסוסנוביץ properName unspecified unspecified unspecified unspecified unspecified  	I_PERS	null
16 , , , punctuation unspecified unspecified unspecified unspecified unspecified  	O	null
17 ו ו ובירחון conjunction unspecified unspecified unspecified unspecified unspecified 0 
17 ב ב ובירחון preposition unspecified unspecified unspecified unspecified unspecified 0 
17 ה ה ובירחון definiteArticle unspecified unspecified unspecified unspecified unspecified 0 
17 הירחון ירחון ובירחון noun masculine singular absolute unspecified unspecified  	O	null
18 ה ה העברי definiteArticle unspecified unspecified unspecified unspecified unspecified 0 
18 העברי עברי העברי adjective masculine singular absolute unspecified unspecified  	O	null
19 דרך דרך דרכנו preposition unspecified unspecified unspecified unspecified unspecified  
19 נו נו דרכנו pronomial masculine-and-feminine plural unspecified 1 unspecified 0 	O	null
20 ש ש שיצא relativizer/subordinatingConjunction unspecified unspecified unspecified unspecified unspecified 0 
20 יצא יצא שיצא verb masculine singular unspecified 3 past  	I_LOC	null
21 ב ב בוורשה preposition unspecified unspecified unspecified unspecified unspecified 0 
21 וורשה ורשה בוורשה properName unspecified unspecified unspecified unspecified unspecified  	I_LOC	null
22 . . . punctuation unspecified unspecified unspecified unspecified unspecified  	O	null

0 ספר ספר ספר noun masculine singular construct unspecified unspecified  	O	null
1 שירי שיר שיריו noun masculine plural absolute unspecified unspecified  
1 ו ו שיריו possessive masculine singular unspecified 3 unspecified 0 	O	null
2 ה ה הראשון definiteArticle unspecified unspecified unspecified unspecified unspecified 0 
2 הראשון ORD1 הראשון numeral masculine singular absolute unspecified unspecified  	O	null
3 , , , punctuation unspecified unspecified unspecified unspecified unspecified  	O	null
4 ש ש שנכתב relativizer/subordinatingConjunction unspecified unspecified unspecified unspecified unspecified 0 
4 נכתב נכתב שנכתב verb masculine singular unspecified 3 past  	O	null
5 ב ב ביידיש preposition unspecified unspecified unspecified unspecified unspecified 0 
5 יידיש יידיש ביידיש properName feminine singular unspecified unspecified unspecified  	I_PERS	null
6 ו ו ונקרא conjunction unspecified unspecified unspecified unspecified unspecified 0 
6 נקרא נקרא ונקרא verb masculine singular unspecified 3 past  	O	null
7 עשרים ORD-CARD20 עשרים numeral masculine-and-feminine plural construct unspecified unspecified  	O	null
8 ו ו ושתיים conjunction unspecified unspecified unspecified unspecified unspecified 0 
8 שתיים CARD2 ושתיים numeral feminine singular absolute unspecified unspecified  	O	null
9 על על על preposition unspecified unspecified unspecified unspecified unspecified  	O	null
10 שום שום שום quantifier unspecified unspecified construct unspecified unspecified  	O	null
11 עשרים ORD-CARD20 עשרים numeral masculine-and-feminine plural construct unspecified unspecified  	O	null
12 ו ו ושניים conjunction unspecified unspecified unspecified unspecified unspecified 0 
12 שניים ORD2 ושניים numeral masculine plural absolute unspecified unspecified  	O	null
13 ה ה השירים definiteArticle unspecified unspecified unspecified unspecified unspecified 0 
13 השירים שיר השירים noun masculine plural absolute unspecified unspecified  	O	null
14 ש ש שכלל relativizer/subordinatingConjunction unspecified unspecified unspecified unspecified unspecified 0 
14 כלל כלל שכלל adverb unspecified unspecified unspecified unspecified unspecified  	I_LOC	null
15 , , , punctuation unspecified unspecified unspecified unspecified unspecified  	O	null
16 יצא יצא יצא verb masculine singular unspecified 3 past  	O	null
17 ל ל לאור preposition unspecified unspecified unspecified unspecified unspecified 0 
17 אור אור לאור noun masculine singular absolute unspecified unspecified  	O	null
18 ב ב בוורשה preposition unspecified unspecified unspecified unspecified unspecified 0 
18 וורשה ורשה בוורשה properName unspecified unspecified unspecified unspecified unspecified  	I_LOC	null
19 על על על preposition unspecified unspecified unspecified unspecified unspecified  	O	null
20 ידי יד ידי noun feminine plural construct unspecified unspecified  	O	null
21 " " " punctuation unspecified unspecified unspecified unspecified unspecified  	I_ORG	null
22 קולטור קולטור קולטור properName unspecified unspecified unspecified unspecified unspecified  	I_ORG	null
23 ל ל ליגע preposition unspecified unspecified unspecified unspecified unspecified 0 
23 יגע יגע ליגע noun masculine singular absolute unspecified unspecified  	O	null
24 " " " punctuation unspecified unspecified unspecified unspecified unspecified  	O	null
25 ב ב ב preposition unspecified unspecified unspecified unspecified unspecified 0 	O	null
26 - - - punctuation unspecified unspecified unspecified unspecified unspecified  	O	null
27 . . . punctuation unspecified unspecified unspecified unspecified unspecified  	O	null
28 ב ב בתקופת preposition unspecified unspecified unspecified unspecified unspecified 0 
28 תקופת תקופה בתקופת noun feminine singular construct unspecified unspecified  	O	null
29 ###NUMBER### ###NUMBER### ###NUMBER### numeral unspecified unspecified unspecified unspecified unspecified  	I_DATE	null
30 ה ה המלחמה definiteArticle unspecified unspecified unspecified unspecified unspecified 0 
30 המלחמה מלחמה המלחמה noun feminine singular absolute unspecified unspecified  	O	null
31 , , , punctuation unspecified unspecified unspecified unspecified unspecified  	O	null
32 לאחר לאחר לאחר conjunction unspecified unspecified unspecified unspecified unspecified  	O	null
33 שהות שהות שהות noun feminine singular absolute unspecified unspecified  	O	null
34 ממושכת ממושך ממושכת adjective feminine singular absolute unspecified unspecified  	O	null
35 ב ב בגטו preposition unspecified unspecified unspecified unspecified unspecified 0 
35 ה ה בגטו definiteArticle unspecified unspecified unspecified unspecified unspecified 0 
35 הגטו גטו בגטו noun masculine singular absolute unspecified unspecified  	O	null
36 , , , punctuation unspecified unspecified unspecified unspecified unspecified  	O	null
37 נשלח נשלח נשלח verb masculine singular unspecified 3 past  	O	null
38 ל ל לאושוויץ preposition unspecified unspecified unspecified unspecified unspecified 0 
38 אושוויץ אושוויץ לאושוויץ properName unspecified unspecified unspecified unspecified unspecified  	I_LOC	null
39 . . . punctuation unspecified unspecified unspecified unspecified unspecified  	O	null

0 הוא הוא הוא pronoun masculine singular unspecified 3 unspecified  	O	null
1 עצמו עצמו עצמו pronoun unspecified unspecified unspecified unspecified unspecified  
1 ו ו עצמו pronomial masculine singular unspecified 3 unspecified 0 	O	null
2 ניצל ניצל ניצל verb masculine singular unspecified 3 past  	O	null
3 , , , punctuation unspecified unspecified unspecified unspecified unspecified  	O	null
4 אך אך אך conjunction unspecified unspecified unspecified unspecified unspecified  	O	null
5 אשת איש אשתו noun feminine singular absolute unspecified unspecified  
5 ו ו אשתו possessive masculine singular unspecified 3 unspecified 0 	O	null
6 ו ו וילדיו conjunction unspecified unspecified unspecified unspecified unspecified 0 
6 ילדי ילד וילדיו noun masculine plural absolute unspecified unspecified  
6 ו ו וילדיו possessive masculine singular unspecified 3 unspecified 0 	O	null
7 נספו נספה נספו verb masculine-and-feminine plural unspecified 3 past  	O	null
8 . . . punctuation unspecified unspecified unspecified unspecified unspecified  	O	null

0 הוא הוא הוא pronoun masculine singular unspecified 3 unspecified  	O	null
1 עלה עלה עלה verb masculine singular unspecified 2 imperative  	O	null
2 ל ל לארץ preposition unspecified unspecified unspecified unspecified unspecified 0 
2 ה ה לארץ definiteArticle unspecified unspecified unspecified unspecified unspecified 0 
2 הארץ ארץ לארץ properName unspecified unspecified unspecified unspecified unspecified  	O	null
3 ב ב ב preposition unspecified unspecified unspecified unspecified unspecified 0 	O	null
4 - - - punctuation unspecified unspecified unspecified unspecified unspecified  	O	null
5 , , , punctuation unspecified unspecified unspecified unspecified unspecified  	O	null
6 ###NUMBER### ###NUMBER### ###NUMBER### numeral unspecified unspecified unspecified unspecified unspecified  	I_DATE	null
7 ב ב במסגרת preposition unspecified unspecified unspecified unspecified unspecified 0 
7 מסגרת מסגרת במסגרת noun feminine singular construct unspecified unspecified  	O	null
8 מבצע מבצע מבצע noun masculine singular construct unspecified unspecified  	O	null
9 בריחה בריחה בריחה noun feminine singular absolute unspecified unspecified  	O	null
10 ש ש שאורגן relativizer/subordinatingConjunction unspecified unspecified unspecified unspecified unspecified 0 
10 אורגן אורגן שאורגן verb masculine singular unspecified 3 past  	O	null
11 על על על preposition unspecified unspecified unspecified unspecified unspecified  	O	null
12 ידי יד ידי noun feminine plural construct unspecified unspecified  	O	null
13 ה ה הבריגדה definiteArticle unspecified unspecified unspecified unspecified unspecified 0 
13 הבריגדה הבריגדה הבריגדה noun feminine singular absolute unspecified unspecified  	O	null
14 ה ה היהודית definiteArticle unspecified unspecified unspecified unspecified unspecified 0 
14 היהודית יהודי היהודית adjective feminine singular absolute unspecified unspecified  	O	null
15 ו ו ו conjunction unspecified unspecified unspecified unspecified unspecified 0 	O	null
16 " " " punctuation unspecified unspecified unspecified unspecified unspecified  	O	null
17 ה ה ההגנה definiteArticle unspecified unspecified unspecified unspecified unspecified 0 
17 ההגנה הגנה ההגנה noun feminine singular absolute unspecified unspecified  	O	null
18 " " " punctuation unspecified unspecified unspecified unspecified unspecified  	O	null
19 , , , punctuation unspecified unspecified unspecified unspecified unspecified  	O	null
20 שינה שינה שינה noun feminine singular absolute unspecified unspecified  	O	null
21 את את את at-preposition unspecified unspecified unspecified unspecified unspecified  	O	null
22 שם שם שמו participle masculine singular unspecified any unspecified  
22 ו ו שמו possessive masculine singular unspecified 3 unspecified 0 	O	null
23 מ מ מפיינר preposition unspecified unspecified unspecified unspecified unspecified 0 
23 פיינר פיינר מפיינר properName unspecified unspecified unspecified unspecified unspecified  	I_ORG	null
24 לדי ילד לדי verb feminine singular unspecified 2 imperative  	O	null
25 - - - properName unspecified unspecified unspecified unspecified unspecified  	I_ORG	null
26 נור נור נור properName unspecified unspecified unspecified unspecified unspecified  	I_ORG	null
27 ו ו והתחתן conjunction unspecified unspecified unspecified unspecified unspecified 0 
27 התחתן התחתן והתחתן verb masculine singular unspecified 3 past  	O	null
28 עם עם עם preposition unspecified unspecified unspecified unspecified unspecified  	O	null
29 נינה נינה נינה properName feminine singular unspecified unspecified unspecified  	I_PERS	null
30 אשרם אשרם אשרמן noun masculine singular absolute unspecified unspecified  
30 ן ן אשרמן possessive feminine plural unspecified 3 unspecified 0 	O	null
31 , , , punctuation unspecified unspecified unspecified unspecified unspecified  	O	null
32 מן מן ממנה preposition unspecified unspecified unspecified unspecified unspecified  
32 ה ה ממנה pronomial feminine singular unspecified 3 unspecified 0 	O	null
33 נולדו נולד נולדו verb masculine-and-feminine plural unspecified 3 past  	O	null
34 לו לו לו conjunction unspecified unspecified unspecified unspecified unspecified  	O	null
35 שני שני שני noun masculine singular construct unspecified unspecified  	O	null
36 ילדים ילד ילדים noun masculine plural absolute unspecified unspecified  	O	null
37 , , , punctuation unspecified unspecified unspecified unspecified unspecified  	O	null
38 ליאור ליאור ליאור properName unspecified unspecified unspecified unspecified unspecified  	I_PERS	null
39 ו ו ודניאלה conjunction unspecified unspecified unspecified unspecified unspecified 0 
39 דניאלה דניאלה ודניאלה properName unspecified unspecified unspecified unspecified unspecified  	I_PERS	null
40 , , , punctuation unspecified unspecified unspecified unspecified unspecified  	O	null
41 מוציאה הוציא מוציאה verb feminine singular unspecified any beinoni  	O	null
42 לאור לאור לאור preposition unspecified unspecified unspecified unspecified unspecified  	O	null
43 . . . punctuation unspecified unspecified unspecified unspecified unspecified  	O	null

0 מיד מייד מיד adverb unspecified unspecified unspecified unspecified unspecified  	O	null
1 לאחר לאחר לאחר preposition unspecified unspecified unspecified unspecified unspecified  	O	null
2 שחרור שחרור שחרורו noun masculine singular absolute unspecified unspecified  
2 ו ו שחרורו possessive masculine singular unspecified 3 unspecified 0 	O	null
3 החל החל החל verb masculine singular unspecified 3 past  	O	null
4 לתעד תיעד לתעד verb unspecified unspecified unspecified unspecified infinitive  	O	null
5 ב ב בעקביות preposition unspecified unspecified unspecified unspecified unspecified 0 
5 עקביות עקביות בעקביות noun feminine singular absolute unspecified unspecified  	O	null
6 את את את at-preposition unspecified unspecified unspecified unspecified unspecified  	O	null
7 חוויות חוויה חוויותיו noun feminine plural absolute unspecified unspecified  
7 ו ו חוויותיו possessive masculine singular unspecified 3 unspecified 0 	O	null
8 ו ו וחוויות conjunction unspecified unspecified unspecified unspecified unspecified 0 
8 חוויות חוויה וחוויות noun feminine plural construct unspecified unspecified  	O	null
9 בני בן בני noun masculine plural construct unspecified unspecified  	O	null
10 משפחת משפחה משפחתו noun feminine singular absolute unspecified unspecified  
10 ו ו משפחתו possessive masculine singular unspecified 3 unspecified 0 	O	null
11 ב ב בתקופת preposition unspecified unspecified unspecified unspecified unspecified 0 
11 תקופת תקופה בתקופת noun feminine singular construct unspecified unspecified  	O	null
12 ה ה השואה definiteArticle unspecified unspecified unspecified unspecified unspecified 0 
12 השואה שואה השואה noun feminine singular absolute unspecified unspecified  	O	null
13 ב ב בשם preposition unspecified unspecified unspecified unspecified unspecified 0 
13 שם שם בשם noun masculine singular construct unspecified unspecified  	O	null
14 ה ה העט definiteArticle unspecified unspecified unspecified unspecified unspecified 0 
14 העט עט העט noun masculine singular absolute unspecified unspecified  	O	null
15 ק' ק' ק' properName unspecified unspecified unspecified unspecified unspecified  	I_PERS	null
16 צטניק צטניק צטניק noun masculine singular absolute unspecified unspecified  	O	null
17 . . . punctuation unspecified unspecified unspecified unspecified unspecified  	O	null

0 ה ה השם definiteArticle unspecified unspecified unspecified unspecified unspecified 0 
0 השם שם השם noun masculine singular absolute unspecified unspecified  	O	null
1 לקוח לקוח לקוח noun masculine singular absolute unspecified unspecified  	O	null
2 מ מ מראשיהתיבות preposition unspecified unspecified unspecified unspecified unspecified 0 
2 ראשיהתיבו ראשיהתיבו מראשיהתיבות noun masculine-and-feminine plural absolute unspecified unspecified  
2 י י מראשיהתיבות possessive masculine-and-feminine singular unspecified 1 unspecified 0 	O	null
3 ב ב בגרמנית preposition unspecified unspecified unspecified unspecified unspecified 0 
3 גרמנית גרמנית בגרמנית properName feminine singular unspecified unspecified unspecified  	I_ORG	null
4 ל ל למחנה preposition unspecified unspecified unspecified unspecified unspecified 0 
4 ה ה למחנה definiteArticle unspecified unspecified unspecified unspecified unspecified 0 
4 המחנה החנה למחנה participle masculine singular absolute any unspecified  	I_ORG	null
5 ריכוזKZכקיצור ריכוזKZכקיצור ריכוזKZכקיצור properName unspecified unspecified unspecified unspecified unspecified  	I_ORG	null
6 למילהKonzentrationslager למילהKonzentrationslager למילהKonzentrationslager verb feminine singular unspecified 2 imperative  	O	null
7 , , , punctuation unspecified unspecified unspecified unspecified unspecified  	O	null
8 ו ו ושימש conjunction unspecified unspecified unspecified unspecified unspecified 0 
8 שימש שימש ושימש verb masculine singular unspecified 3 past  	O	null
9 כינוי כינוי כינוי noun masculine singular absolute unspecified unspecified  	O	null
10 מקובל מקובל מקובל adjective masculine singular absolute unspecified unspecified  	O	null
11 בקרב בקרב בקרב preposition unspecified unspecified unspecified unspecified unspecified  	O	null
12 ה ה האסירים definiteArticle unspecified unspecified unspecified unspecified unspecified 0 
12 האסירים אסיר האסירים noun masculine plural absolute unspecified unspecified  	O	null
13 . . . punctuation unspecified unspecified unspecified unspecified unspecified  	O	null

0 ב ב במהדורות preposition unspecified unspecified unspecified unspecified unspecified 0 
0 מהדורות מהדורה במהדורות noun feminine plural construct unspecified unspecified  	O	null
1 ה ה הראשונות definiteArticle unspecified unspecified unspecified unspecified unspecified 0 
1 הראשונות ראשונות הראשונות noun feminine singular absolute unspecified unspecified  	O	null
2 של של של shel-preposition unspecified unspecified unspecified unspecified unspecified  	O	null
3 ספרי ספר ספריו noun masculine plural absolute unspecified unspecified  
3 ו ו ספריו possessive masculine singular unspecified 3 unspecified 0 	O	null
4 הופיע הופיע הופיע verb masculine singular unspecified 3 past  	O	null
5 גם גם גם conjunction unspecified unspecified unspecified unspecified unspecified  	O	null
6 ה ה המספר definiteArticle unspecified unspecified unspecified unspecified unspecified 0 
6 המספר מספר המספר noun masculine singular absolute unspecified unspecified  	O	null
7 , , , punctuation unspecified unspecified unspecified unspecified unspecified  	O	null
8 ###NUMBER### ###NUMBER### ###NUMBER### numeral unspecified unspecified unspecified unspecified unspecified  	O	null
9 ו ו וייתכן conjunction unspecified unspecified unspecified unspecified unspecified 0 
9 ייתכן ייתכן וייתכן adverb unspecified unspecified unspecified unspecified unspecified  	O	null
10 ש ש שהיה relativizer/subordinatingConjunction unspecified unspecified unspecified unspecified unspecified 0 
10 היה הוא שהיה copula masculine singular unspecified 3 past  	O	null
11 זה זה זה pronoun masculine singular unspecified 3 unspecified  	O	null
12 מספר מספר מספרו noun masculine singular absolute unspecified unspecified  
12 ו ו מספרו possessive masculine singular unspecified 3 unspecified 0 	O	null
13 ה ה האישי definiteArticle unspecified unspecified unspecified unspecified unspecified 0 
13 האישי אישי האישי adjective masculine singular absolute unspecified unspecified  	O	null
14 ב ב באושוויץ preposition unspecified unspecified unspecified unspecified unspecified 0 
14 אושוויץ אושוויץ באושוויץ properName unspecified unspecified unspecified unspecified unspecified  	I_LOC	null
15 . . . punctuation unspecified unspecified unspecified unspecified unspecified  	O	null

0 ספר ספר ספרו noun masculine singular absolute unspecified unspecified  
0 ו ו ספרו possessive masculine singular unspecified 3 unspecified 0 	O	null
1 ה ה הראשון definiteArticle unspecified unspecified unspecified unspecified unspecified 0 
1 הראשון ORD1 הראשון numeral masculine singular absolute unspecified unspecified  	O	null
2 על על על preposition unspecified unspecified unspecified unspecified unspecified  	O	null
3 קורות קורה קורותיו noun feminine plural absolute unspecified unspecified  
3 ו ו קורותיו possessive masculine singular unspecified 3 unspecified 0 	O	null
4 ו ו וקורות conjunction unspecified unspecified unspecified unspecified unspecified 0 
4 קורות קורה וקורות noun feminine plural construct unspecified unspecified  	O	null
5 משפחת משפחה משפחתו noun feminine singular absolute unspecified unspecified  
5 ו ו משפחתו possessive masculine singular unspecified 3 unspecified 0 	O	null
6 ב ב בשואה preposition unspecified unspecified unspecified unspecified unspecified 0 
6 ה ה בשואה definiteArticle unspecified unspecified unspecified unspecified unspecified 0 
6 השואה שואה בשואה noun feminine singular absolute unspecified unspecified  	O	null
7 , , , punctuation unspecified unspecified unspecified unspecified unspecified  	O	null
8 סלמנדרה סלמנדרה סלמנדרה noun feminine singular absolute unspecified unspecified  	O	null
9 , , , punctuation unspecified unspecified unspecified unspecified unspecified  	O	null
10 נכתב נכתב נכתב verb masculine singular unspecified 3 past  	O	null
11 מיד מייד מיד adverb unspecified unspecified unspecified unspecified unspecified  	O	null
12 ב ב בתום preposition unspecified unspecified unspecified unspecified unspecified 0 
12 תום תום בתום noun masculine singular construct unspecified unspecified  	O	null
13 ה ה השואה definiteArticle unspecified unspecified unspecified unspecified unspecified 0 
13 השואה שואה השואה noun feminine singular absolute unspecified unspecified  	O	null
14 ב ב ביידיש preposition unspecified unspecified unspecified unspecified unspecified 0 
14 יידיש יידיש ביידיש properName unspecified unspecified unspecified unspecified unspecified  	I_LOC	null
15 . . . punctuation unspecified unspecified unspecified unspecified unspecified  	O	null

0 זהו זהו זהו pronoun masculine singular unspecified 3 unspecified  	O	null
1 ה ה הספר definiteArticle unspecified unspecified unspecified unspecified unspecified 0 
1 הספר ספר הספר noun masculine singular absolute unspecified unspecified  	O	null
2 ה ה הראשון definiteArticle unspecified unspecified unspecified unspecified unspecified 0 
2 הראשון ORD1 הראשון numeral masculine singular absolute unspecified unspecified  	O	null
3 ב ב בסאגה preposition unspecified unspecified unspecified unspecified unspecified 0 
3 ה ה בסאגה definiteArticle unspecified unspecified unspecified unspecified unspecified 0 
3 הסאגה סאגה בסאגה noun feminine singular absolute unspecified unspecified  	O	null
4 ה ה המשפחתית definiteArticle unspecified unspecified unspecified unspecified unspecified 0 
4 המשפחתית משפחתי המשפחתית adjective feminine singular absolute unspecified unspecified  	O	null
5 ש ש שאותה relativizer/subordinatingConjunction unspecified unspecified unspecified unspecified unspecified 0 
5 את את שאותה at-preposition unspecified unspecified unspecified unspecified unspecified  
5 ה ה שאותה pronomial feminine singular unspecified 3 unspecified 0 	O	null
6 כינה כינה כינה verb masculine singular unspecified 3 past  	O	null
7 " " " punctuation unspecified unspecified unspecified unspecified unspecified  	I_LOC	null
8 כרוניקה כרוניקה כרוניקה properName unspecified unspecified unspecified unspecified unspecified  	I_LOC	null
9 של של של shel-preposition unspecified unspecified unspecified unspecified unspecified  	O	null
10 משפחה משפחה משפחה noun feminine singular absolute unspecified unspecified  	O	null
11 יהודית יהודי יהודית adjective feminine singular absolute unspecified unspecified  	O	null
12 ב ב במאה preposition unspecified unspecified unspecified unspecified unspecified 0 
12 ה ה במאה definiteArticle unspecified unspecified unspecified unspecified unspecified 0 
12 המאה ORD-CARD100 במאה numeral feminine plural absolute unspecified unspecified  	O	null
13 ה ה העשרים definiteArticle unspecified unspecified unspecified unspecified unspecified 0 
13 העשרים ORD-CARD20 העשרים numeral masculine-and-feminine plural absolute unspecified unspecified  	O	null
14 " " " punctuation unspecified unspecified unspecified unspecified unspecified  	O	null
15 , , , punctuation unspecified unspecified unspecified unspecified unspecified  	O	null
16 ש ש שכללה relativizer/subordinatingConjunction unspecified unspecified unspecified unspecified unspecified 0 
16 כללה כלל שכללה verb feminine singular unspecified 3 past  	O	null
17 ב ב בסופו preposition unspecified unspecified unspecified unspecified unspecified 0 
17 סוף סוף בסופו noun masculine singular absolute unspecified unspecified  
17 ו ו בסופו possessive masculine singular unspecified 3 unspecified 0 	O	null
18 של של של shel-preposition unspecified unspecified unspecified unspecified unspecified  	O	null
19 דבר דבר דבר noun masculine singular absolute unspecified unspecified  	O	null
20 שישה CARD6 שישה numeral masculine plural absolute unspecified unspecified  	O	null
21 ספרים ספר ספרים noun masculine plural absolute unspecified unspecified  	O	null
22 , , , punctuation unspecified unspecified unspecified unspecified unspecified  	O	null
23 כולם כולם כולם pronoun masculine plural unspecified 3 unspecified  	O	null
24 מלבד מלבד מלבד preposition unspecified unspecified unspecified unspecified unspecified  	O	null
25 סלמנדרה סלמנדרה סלמנדרה noun feminine singular absolute unspecified unspecified  	O	null
26 נכתבו נכתב נכתבו verb masculine-and-feminine plural unspecified 3 past  	O	null
27 ב ב במקור preposition unspecified unspecified unspecified unspecified unspecified 0 
27 מקור מקור במקור noun masculine singular absolute unspecified unspecified  	O	null
28 ב ב בעברית preposition unspecified unspecified unspecified unspecified unspecified 0 
28 עברית עברית בעברית properName feminine singular unspecified unspecified unspecified  	I_LOC	null
29 . . . punctuation unspecified unspecified unspecified unspecified unspecified  	O	null

0 סלמנדרה סלמנדרה סלמנדרה noun feminine singular absolute unspecified unspecified  	O	null
1 פותח פותח פותח verb masculine singular unspecified 3 past  	O	null
2 ב ב בתיאור preposition unspecified unspecified unspecified unspecified unspecified 0 
2 תיאור תיאור בתיאור noun masculine singular construct unspecified unspecified  	O	null
3 חיי חיים חייו noun masculine plural absolute unspecified unspecified  
3 ו ו חייו possessive masculine singular unspecified 3 unspecified 0 	O	null
4 של של של shel-preposition unspecified unspecified unspecified unspecified unspecified  	O	null
5 אמן אמן אמן noun masculine singular absolute unspecified unspecified  	O	null
6 צעיר צעיר צעיר adjective masculine singular absolute unspecified unspecified  	O	null
7 , , , punctuation unspecified unspecified unspecified unspecified unspecified  	O	null
8 בן בן בן noun masculine singular construct unspecified unspecified  	O	null
9 דמות דמות דמותו noun feminine singular absolute unspecified unspecified  
9 ו ו דמותו possessive masculine singular unspecified 3 unspecified 0 	O	null
10 של של של shel-preposition unspecified unspecified unspecified unspecified unspecified  	O	null
11 ה ה המחבר definiteArticle unspecified unspecified unspecified unspecified unspecified 0 
11 המחבר מחבר המחבר noun masculine singular absolute unspecified unspecified  	O	null
12 , , , punctuation unspecified unspecified unspecified unspecified unspecified  	O	null
13 טרם טרם טרם adverb unspecified unspecified unspecified unspecified unspecified  	O	null
14 אושוויץ אושוויץ אושוויץ properName unspecified unspecified unspecified unspecified unspecified  	I_LOC	null
15 ( ( ( punctuation unspecified unspecified unspecified unspecified unspecified  	O	null
16 שם שם שם noun masculine singular construct unspecified unspecified  	O	null
17 ה ה הגיבור definiteArticle unspecified unspecified unspecified unspecified unspecified 0 
17 הגיבור גיבור הגיבור noun masculine singular absolute unspecified unspecified  	O	null
18 הרי הרי הרי conjunction unspecified unspecified unspecified unspecified unspecified  	O	null
19 פרלשניק פרלשניק פרלשניק properName unspecified unspecified unspecified unspecified unspecified  	I_PERS	null
20 , , , punctuation unspecified unspecified unspecified unspecified unspecified  	O	null
21 ו ו והוא conjunction unspecified unspecified unspecified unspecified unspecified 0 
21 הוא הוא והוא pronoun masculine singular unspecified 3 unspecified  	O	null
22 מופיע הופיע מופיע verb masculine singular unspecified any beinoni  	O	null
23 גם גם גם conjunction unspecified unspecified unspecified unspecified unspecified  	O	null
24 ב ב בספריו preposition unspecified unspecified unspecified unspecified unspecified 0 
24 ספרי ספר בספריו noun masculine plural absolute unspecified unspecified  
24 ו ו בספריו possessive masculine singular unspecified 3 unspecified 0 	O	null
25 ה ה האחרים definiteArticle unspecified unspecified unspecified unspecified unspecified 0 
25 האחרים אחר האחרים adjective masculine plural absolute unspecified unspecified  	O	null
26 ) ) ) punctuation unspecified unspecified unspecified unspecified unspecified  	O	null
27 – – – punctuation unspecified unspecified unspecified unspecified unspecified  	O	null
28 רק רק רק conjunction unspecified unspecified unspecified unspecified unspecified  	O	null
29 ב ב בסופו preposition unspecified unspecified unspecified unspecified unspecified 0 
29 סוף סוף בסופו noun masculine singular absolute unspecified unspecified  
29 ו ו בסופו possessive masculine singular unspecified 3 unspecified 0 	O	null
30 של של של shel-preposition unspecified unspecified unspecified unspecified unspecified  	O	null
31 ה ה הספר definiteArticle unspecified unspecified unspecified unspecified unspecified 0 
31 הספר ספר הספר noun masculine singular absolute unspecified unspecified  	O	null
32 מגיע הגיע מגיע verb masculine singular unspecified any beinoni  	O	null
33 ה ה הגיבור definiteArticle unspecified unspecified unspecified unspecified unspecified 0 
33 הגיבור גיבור הגיבור noun masculine singular absolute unspecified unspecified  	O	null
34 ל ל למחנה preposition unspecified unspecified unspecified unspecified unspecified 0 
34 מחנה מחנה למחנה noun masculine singular construct unspecified unspecified  	O	null
35 ה ה הריכוז definiteArticle unspecified unspecified unspecified unspecified unspecified 0 
35 הריכוז ריכוז הריכוז noun masculine singular absolute unspecified unspecified  	O	null
36 . . . punctuation unspecified unspecified unspecified unspecified unspecified  	O	null

0 סלמנדרה סלמנדרה סלמנדרה noun feminine singular absolute unspecified unspecified  	O	null
1 תורגם תורגם תורגם verb masculine singular unspecified 3 past  	O	null
2 ל ל לעברית preposition unspecified unspecified unspecified unspecified unspecified 0 
2 עברית עברית לעברית properName feminine singular unspecified unspecified unspecified  	O	null
3 על על על preposition unspecified unspecified unspecified unspecified unspecified  	O	null
4 ידי יד ידי noun feminine plural construct unspecified unspecified  	O	null
5 י"ד י"ד י"ד properName unspecified unspecified unspecified unspecified unspecified  	I_ORG	null
6 ברקוביץלפי ברקוביץלפי ברקוביץלפי properName unspecified unspecified unspecified unspecified unspecified  	I_ORG	null
7 גרסה גרסה גרסה noun feminine singular absolute unspecified unspecified  	O	null
8 אחת CARD1 אחת numeral feminine singular absolute unspecified unspecified  	O	null
9 , , , punctuation unspecified unspecified unspecified unspecified unspecified  	O	null
10 או או או conjunction unspecified unspecified unspecified unspecified unspecified  	O	null
11 על על על preposition unspecified unspecified unspecified unspecified unspecified  	O	null
12 ידי יד ידי noun feminine plural construct unspecified unspecified  	O	null
13 י"ל י"ל י"ל properName unspecified unspecified unspecified unspecified unspecified  	I_ORG	null
14 ברוך ברוך ברוך properName unspecified unspecified unspecified unspecified unspecified  	I_ORG	null
15 ( ( ( punctuation unspecified unspecified unspecified unspecified unspecified  	O	null
16 ב ב בהגהה preposition unspecified unspecified unspecified unspecified unspecified 0 
16 הגהה הגהה בהגהה noun feminine singular absolute unspecified unspecified  	O	null
17 בלבד בלבד בלבד adverb unspecified unspecified unspecified unspecified unspecified  	O	null
18 של של של shel-preposition unspecified unspecified unspecified unspecified unspecified  	O	null
19 י"ד י"ד י"ד properName unspecified unspecified unspecified unspecified unspecified  	I_PERS	null
20 ברקוביץ ברקוביץ ברקוביץ properName unspecified unspecified unspecified unspecified unspecified  	I_PERS	null
21 ) ) ) punctuation unspecified unspecified unspecified unspecified unspecified  	O	null
22 לפי לפי לפי preposition unspecified unspecified unspecified unspecified unspecified  	O	null
23 גרסה גרסה גרסה noun feminine singular absolute unspecified unspecified  	O	null
24 אחרת אחר אחרת adjective feminine singular absolute unspecified unspecified  	O	null
25 , , , punctuation unspecified unspecified unspecified unspecified unspecified  	O	null
26 ו ו ופורסם conjunction unspecified unspecified unspecified unspecified unspecified 0 
26 פורסם פורסם ופורסם verb masculine singular unspecified 3 past  	O	null
27 ב ב בהוצאת preposition unspecified unspecified unspecified unspecified unspecified 0 
27 הוצאת הוצאה בהוצאת noun feminine singular construct unspecified unspecified  	O	null
28 דביר דביר דביר properName unspecified unspecified unspecified unspecified unspecified  	I_PERS	null
29 ב ב ב preposition unspecified unspecified unspecified unspecified unspecified 0 	I_ORG	null
30 - - - punctuation unspecified unspecified unspecified unspecified unspecified  	I_ORG	null
31 ###NUMBER### ###NUMBER### ###NUMBER### numeral unspecified unspecified unspecified unspecified unspecified  	I_DATE	null
32 . . . punctuation unspecified unspecified unspecified unspecified unspecified  	O	null

0 אחד איחד אחד verb masculine singular unspecified 3 past  	O	null
1 מ מ מפרקי preposition unspecified unspecified unspecified unspecified unspecified 0 
1 פרקי פרק מפרקי noun masculine plural construct unspecified unspecified  	O	null
2 ה ה הספר definiteArticle unspecified unspecified unspecified unspecified unspecified 0 
2 הספר ספר הספר noun masculine singular absolute unspecified unspecified  	O	null
3 נדפס נדפס נדפס verb masculine singular unspecified 3 past  	O	null
4 תחילה תחילה תחילה adverb unspecified unspecified unspecified unspecified unspecified  	O	null
5 ב ב במאסף preposition unspecified unspecified unspecified unspecified unspecified 0 
5 מאסף מאסף במאסף noun masculine singular absolute unspecified unspecified  	O	null
6 של של של shel-preposition unspecified unspecified unspecified unspecified unspecified  	O	null
7 אגודת אגודה אגודת noun feminine singular construct unspecified unspecified  	O	null
8 ה ה הסופרים definiteArticle unspecified unspecified unspecified unspecified unspecified 0 
8 הסופרים סופר הסופרים noun masculine plural absolute unspecified unspecified  	O	null
9 מעט מעט מעט adverb unspecified unspecified unspecified unspecified unspecified  	O	null
10 מ מ מהרבהבעריכתו preposition unspecified unspecified unspecified unspecified unspecified 0 
10 הרבהבעריכתו הרבהבעריכתו מהרבהבעריכתו adjective masculine singular construct unspecified unspecified  	O	null
11 של של של shel-preposition unspecified unspecified unspecified unspecified unspecified  	O	null
12 ג' ג' ג' noun masculine singular absolute unspecified unspecified  	O	null
13 שופמן שופמן שופמן adjective masculine singular absolute unspecified unspecified  	O	null
14 תחת תחת תחת preposition unspecified unspecified unspecified unspecified unspecified  	O	null
15 ה ה הכותרת definiteArticle unspecified unspecified unspecified unspecified unspecified 0 
15 הכותרת כותרת הכותרת noun feminine singular absolute unspecified unspecified  	O	null
16 " " " punctuation unspecified unspecified unspecified unspecified unspecified  	O	null
17 אושוויץ אושוויץ אושוויץ properName unspecified unspecified unspecified unspecified unspecified  	I_ORG	null
18 " " " punctuation unspecified unspecified unspecified unspecified unspecified  	O	null
19 . . . punctuation unspecified unspecified unspecified unspecified unspecified  	O	null

0 ב ב ב preposition unspecified unspecified unspecified unspecified unspecified 0 	I_ORG	null
1 - - - punctuation unspecified unspecified unspecified unspecified unspecified  	I_ORG	null
2 ###NUMBER### ###NUMBER### ###NUMBER### numeral unspecified unspecified unspecified unspecified unspecified  	I_DATE	null
3 יצאה יצא יצאה verb feminine singular unspecified 3 past  	O	null
4 לאור לאור לאור preposition unspecified unspecified unspecified unspecified unspecified  	O	null
5 ה ה המהדורה definiteArticle unspecified unspecified unspecified unspecified unspecified 0 
5 המהדורה מהדורה המהדורה noun feminine singular absolute unspecified unspecified  	O	null
6 ה ה המקורית definiteArticle unspecified unspecified unspecified unspecified unspecified 0 
6 המקורית מקורי המקורית adjective feminine singular absolute unspecified unspecified  	O	null
7 ה ה המלאה definiteArticle unspecified unspecified unspecified unspecified unspecified 0 
7 המלאה מלא המלאה adjective feminine singular absolute unspecified unspecified  	O	null
8 ו ו והבלתי conjunction unspecified unspecified unspecified unspecified unspecified 0 
8 ה ה והבלתי definiteArticle unspecified unspecified unspecified unspecified unspecified 0 
8 הבלתי בלתי והבלתי wPrefix unspecified unspecified unspecified unspecified unspecified  	I_ORG	null
9 - - - punctuation unspecified unspecified unspecified unspecified unspecified  	I_ORG	null
10 ערוכה ערוך ערוכה adjective feminine singular absolute unspecified unspecified  	I_ORG	null
11 ב ב ביידיש preposition unspecified unspecified unspecified unspecified unspecified 0 
11 יידיש יידיש ביידיש properName feminine singular unspecified unspecified unspecified  	I_ORG	null
12 ו ו ובעברית conjunction unspecified unspecified unspecified unspecified unspecified 0 
12 ב ב ובעברית preposition unspecified unspecified unspecified unspecified unspecified 0 
12 ה ה ובעברית definiteArticle unspecified unspecified unspecified unspecified unspecified 0 
12 העברית עברית ובעברית properName feminine singular unspecified unspecified unspecified  	I_ORG	null
13 בלוויית בלוויית בלוויית preposition unspecified unspecified unspecified unspecified unspecified  	O	null
14 הערות הערה הערות noun feminine plural absolute unspecified unspecified  	O	null
15 של של של shel-preposition unspecified unspecified unspecified unspecified unspecified  	O	null
16 יחיאל יחיאל יחיאל properName unspecified unspecified unspecified unspecified unspecified  	I_PERS	null
17 ש ש שיינטוך relativizer/subordinatingConjunction unspecified unspecified unspecified unspecified unspecified 0 
17 יינטוך יינטוך שיינטוך properName unspecified unspecified unspecified unspecified unspecified  	I_PERS	null
18 , , , punctuation unspecified unspecified unspecified unspecified unspecified  	O	null
19 ש ש שערך relativizer/subordinatingConjunction unspecified unspecified unspecified unspecified unspecified 0 
19 ערך ערך שערך verb masculine singular unspecified 3 past  	O	null
20 מחקר מחקר מחקר noun masculine singular absolute unspecified unspecified  	O	null
21 מקיף מקיף מקיף adjective masculine singular absolute unspecified unspecified  	O	null
22 על על על preposition unspecified unspecified unspecified unspecified unspecified  	O	null
23 חיי חיים חייו noun masculine plural absolute unspecified unspecified  
23 ו ו חייו possessive masculine singular unspecified 3 unspecified 0 	O	null
24 ו ו ופירסם conjunction unspecified unspecified unspecified unspecified unspecified 0 
24 פירסם פרסם ופירסם verb masculine singular unspecified 3 past  	O	null
25 את את אותו at-preposition unspecified unspecified unspecified unspecified unspecified  
25 ו ו אותו pronomial masculine singular unspecified 3 unspecified 0 	O	null
26 ב ב בספר preposition unspecified unspecified unspecified unspecified unspecified 0 
26 ה ה בספר definiteArticle unspecified unspecified unspecified unspecified unspecified 0 
26 הספר ספר בספר noun masculine singular absolute unspecified unspecified  	O	null
27 מסיח הסיח מסיח verb masculine singular unspecified any beinoni  	O	null
28 על על על preposition unspecified unspecified unspecified unspecified unspecified  	O	null
29 פי פה פי noun masculine singular construct unspecified unspecified  	O	null
30 תום תום תומו noun masculine singular absolute unspecified unspecified  
30 ו ו תומו possessive masculine singular unspecified 3 unspecified 0 	O	null
31 – – – punctuation unspecified unspecified unspecified unspecified unspecified  	O	null
32 שיחות שיחה שיחות noun feminine plural absolute unspecified unspecified  	O	null
33 עם עם עם preposition unspecified unspecified unspecified unspecified unspecified  	O	null
34 יחיאל יחיאל יחיאל properName unspecified unspecified unspecified unspecified unspecified  	I_PERS	null
35 די די די adverb unspecified unspecified unspecified unspecified unspecified  	O	null
36 - - - punctuation unspecified unspecified unspecified unspecified unspecified  	O	null
37 נור נור נור properName unspecified unspecified unspecified unspecified unspecified  	I_PERS	null
38 . . . punctuation unspecified unspecified unspecified unspecified unspecified  	O	null

0 ספר ספר ספרו noun masculine singular absolute unspecified unspecified  
0 ו ו ספרו possessive masculine singular unspecified 3 unspecified 0 	O	null
1 ה ה השני definiteArticle unspecified unspecified unspecified unspecified unspecified 0 
1 השני ORD2 השני numeral masculine singular absolute unspecified unspecified  	O	null
2 של של של shel-preposition unspecified unspecified unspecified unspecified unspecified  	O	null
3 ק' ק' ק' properName unspecified unspecified unspecified unspecified unspecified  	I_PERS	null
4 צטניק צטניק צטניק noun masculine singular absolute unspecified unspecified  	O	null
5 , , , punctuation unspecified unspecified unspecified unspecified unspecified  	O	null
6 בית בית בית noun masculine singular construct unspecified unspecified  	O	null
7 ה ה הבובות definiteArticle unspecified unspecified unspecified unspecified unspecified 0 
7 הבובות בובה הבובות noun feminine plural absolute unspecified unspecified  	O	null
8 , , , punctuation unspecified unspecified unspecified unspecified unspecified  	O	null
9 ש ש שמתרחש relativizer/subordinatingConjunction unspecified unspecified unspecified unspecified unspecified 0 
9 מתרחש התרחש שמתרחש verb masculine singular unspecified any beinoni  	O	null
10 ב ב באושוויץ preposition unspecified unspecified unspecified unspecified unspecified 0 
10 אושוויץ אושוויץ באושוויץ properName unspecified unspecified unspecified unspecified unspecified  	I_LOC	null
11 , , , punctuation unspecified unspecified unspecified unspecified unspecified  	O	null
12 יצא יצא יצא verb masculine singular unspecified 3 past  	O	null
13 ל ל לאור preposition unspecified unspecified unspecified unspecified unspecified 0 
13 אור אור לאור noun masculine singular absolute unspecified unspecified  	O	null
14 ב ב ב preposition unspecified unspecified unspecified unspecified unspecified 0 	O	null
15 - - - punctuation unspecified unspecified unspecified unspecified unspecified  	O	null
16 ו ו ובמרכזו conjunction unspecified unspecified unspecified unspecified unspecified 0 
16 ב ב ובמרכזו preposition unspecified unspecified unspecified unspecified unspecified 0 
16 מרכז מרכז ובמרכזו noun masculine singular absolute unspecified unspecified  
16 ו ו ובמרכזו possessive masculine singular unspecified 3 unspecified 0 	O	null
17 ###NUMBER### ###NUMBER### ###NUMBER### numeral unspecified unspecified unspecified unspecified unspecified  	I_DATE	null
18 מתוארים תואר מתוארים verb masculine plural unspecified any beinoni  	O	null
19 לכאורה לכאורה לכאורה adverb unspecified unspecified unspecified unspecified unspecified  	O	null
20 חיי חיים חיי noun masculine plural construct unspecified unspecified  	O	null
21 אחות אח אחותו noun feminine singular absolute unspecified unspecified  
21 ו ו אחותו possessive masculine singular unspecified 3 unspecified 0 	O	null
22 , , , punctuation unspecified unspecified unspecified unspecified unspecified  	O	null
23 תורגם תורגם תורגם verb masculine singular unspecified 3 past  	O	null
24 ל ל לעשרות preposition unspecified unspecified unspecified unspecified unspecified 0 
24 עשרות CARD10 לעשרות numeral feminine plural construct unspecified unspecified  	O	null
25 שפות שפה שפות noun feminine plural absolute unspecified unspecified  	O	null
26 . . . punctuation unspecified unspecified unspecified unspecified unspecified  	O	null

0 סיפור סיפור סיפורו noun masculine singular absolute unspecified unspecified  
0 ו ו סיפורו possessive masculine singular unspecified 3 unspecified 0 	O	null
1 של של של shel-preposition unspecified unspecified unspecified unspecified unspecified  	O	null
2 אחי אח אחיו noun masculine plural absolute unspecified unspecified  
2 ו ו אחיו possessive masculine singular unspecified 3 unspecified 0 	O	null
3 ש ש שעבר relativizer/subordinatingConjunction unspecified unspecified unspecified unspecified unspecified 0 
3 עבר עבר שעבר verb masculine singular unspecified 3 past  	O	null
4 התעללות התעללות התעללות noun feminine singular absolute unspecified unspecified  	O	null
5 מינית מיני מינית adjective feminine singular absolute unspecified unspecified  	O	null
6 מ מ מתואר preposition unspecified unspecified unspecified unspecified unspecified 0 
6 תואר תואר מתואר noun masculine singular absolute unspecified unspecified  	O	null
7 ב ב בספר preposition unspecified unspecified unspecified unspecified unspecified 0 
7 ה ה בספר definiteArticle unspecified unspecified unspecified unspecified unspecified 0 
7 הספר ספר בספר noun masculine singular absolute unspecified unspecified  	O	null
8 ה ה השלישי definiteArticle unspecified unspecified unspecified unspecified unspecified 0 
8 השלישי ORD3 השלישי numeral masculine singular absolute unspecified unspecified  	O	null
9 , , , punctuation unspecified unspecified unspecified unspecified unspecified  	O	null
10 קראו קרא קראו verb masculine-and-feminine plural unspecified 3 past  	O	null
11 לו לו לו conjunction unspecified unspecified unspecified unspecified unspecified  	O	null
12 פיפל פיפל פיפל noun masculine plural absolute unspecified unspecified  	O	null
13 ( ( ( punctuation unspecified unspecified unspecified unspecified unspecified  	O	null
14 ) ) ) punctuation unspecified unspecified unspecified unspecified unspecified  	O	null
15 . . . punctuation unspecified unspecified unspecified unspecified unspecified  	O	null
16 ###NUMBER### ###NUMBER### ###NUMBER### numeral unspecified unspecified unspecified unspecified unspecified  	I_DATE	null
17 ב ב ב preposition unspecified unspecified unspecified unspecified unspecified 0 	O	null
18 - - - punctuation unspecified unspecified unspecified unspecified unspecified  	O	null
19 היה הוא היה copula masculine singular unspecified 3 past  	O	null
20 אחד איחד אחד verb masculine singular unspecified 3 past  	O	null
21 ה ה העדים definiteArticle unspecified unspecified unspecified unspecified unspecified 0 
21 העדים עד העדים noun masculine plural absolute unspecified unspecified  	O	null
22 ב ב במשפטו preposition unspecified unspecified unspecified unspecified unspecified 0 
22 משפט משפט במשפטו noun masculine singular absolute unspecified unspecified  
22 ו ו במשפטו possessive masculine singular unspecified 3 unspecified 0 	O	null
23 של של של shel-preposition unspecified unspecified unspecified unspecified unspecified  	O	null
24 אדולף אדולף אדולף properName unspecified unspecified unspecified unspecified unspecified  	I_PERS	null
25 אייכמן אייכמן אייכמן properName unspecified unspecified unspecified unspecified unspecified  	I_PERS	null
26 ו ו והותיר conjunction unspecified unspecified unspecified unspecified unspecified 0 
26 הותיר הותיר והותיר verb masculine singular unspecified 3 past  	O	null
27 את את את at-preposition unspecified unspecified unspecified unspecified unspecified  	O	null
28 ה ה הציבור definiteArticle unspecified unspecified unspecified unspecified unspecified 0 
28 הציבור ציבור הציבור noun masculine singular absolute unspecified unspecified  	O	null
29 ב ב בהלם preposition unspecified unspecified unspecified unspecified unspecified 0 
29 הלם הלם בהלם noun masculine singular absolute unspecified unspecified  	O	null
30 כש כש כשהתמוטט temporalSubConj unspecified unspecified unspecified unspecified unspecified 0 
30 התמוטט התמוטט כשהתמוטט verb masculine singular unspecified 3 past  	O	null
31 ו ו והתעלף conjunction unspecified unspecified unspecified unspecified unspecified 0 
31 התעלף התעלף והתעלף verb masculine singular unspecified 3 past  	O	null
32 זמן זמן זמן noun masculine singular absolute unspecified unspecified  	O	null
33 קצר קצר קצר adjective masculine singular absolute unspecified unspecified  	O	null
34 לאחר לאחר לאחר conjunction unspecified unspecified unspecified unspecified unspecified  	O	null
35 ש ש שהחל relativizer/subordinatingConjunction unspecified unspecified unspecified unspecified unspecified 0 
35 החל החל שהחל verb masculine singular unspecified 3 past  	O	null
36 ב ב בעדותו preposition unspecified unspecified unspecified unspecified unspecified 0 
36 עדות עדות בעדותו noun feminine singular absolute unspecified unspecified  
36 ו ו בעדותו possessive masculine singular unspecified 3 unspecified 0 	O	null
37 . . . punctuation unspecified unspecified unspecified unspecified unspecified  	O	null

0 ב ב במשפטים preposition unspecified unspecified unspecified unspecified unspecified 0 
0 ה ה במשפטים definiteArticle unspecified unspecified unspecified unspecified unspecified 0 
0 המשפטים משפט במשפטים noun masculine plural absolute unspecified unspecified  	O	null
1 ה ה הקצרים definiteArticle unspecified unspecified unspecified unspecified unspecified 0 
1 הקצרים קצר הקצרים adjective masculine plural absolute unspecified unspecified  	O	null
2 ש ש שהספיק relativizer/subordinatingConjunction unspecified unspecified unspecified unspecified unspecified 0 
2 הספיק הספיק שהספיק verb masculine singular unspecified 3 past  	O	null
3 לומר אמר לומר verb unspecified unspecified unspecified unspecified infinitive  	O	null
4 הסביר הסביר הסביר verb masculine singular unspecified 3 past  	O	null
5 את את את at-preposition unspecified unspecified unspecified unspecified unspecified  	O	null
6 שם שם שם noun masculine singular construct unspecified unspecified  	O	null
7 ה ה העט definiteArticle unspecified unspecified unspecified unspecified unspecified 0 
7 העט עט העט noun masculine singular absolute unspecified unspecified  	O	null
8 ק' ק' ק' properName unspecified unspecified unspecified unspecified unspecified  	O	null
9 צטניק צטניק צטניק noun masculine singular absolute unspecified unspecified  	O	null
10 ו ו וטבע conjunction unspecified unspecified unspecified unspecified unspecified 0 
10 טבע טבע וטבע noun masculine singular absolute unspecified unspecified  	O	null
11 את את את at-preposition unspecified unspecified unspecified unspecified unspecified  	O	null
12 ה ה הכינוי definiteArticle unspecified unspecified unspecified unspecified unspecified 0 
12 הכינוי כינוי הכינוי noun masculine singular absolute unspecified unspecified  	O	null
13 " " " punctuation unspecified unspecified unspecified unspecified unspecified  	O	null
14 פלנטה פלנטה פלנטה properName unspecified unspecified unspecified unspecified unspecified  	I_ORG	null
15 אחרת אחר אחרת adjective feminine singular absolute unspecified unspecified  	O	null
16 " " " punctuation unspecified unspecified unspecified unspecified unspecified  	O	null
17 ל ל לאושוויץ preposition unspecified unspecified unspecified unspecified unspecified 0 
17 אושוויץ אושוויץ לאושוויץ properName unspecified unspecified unspecified unspecified unspecified  	I_LOC	null
18 , , , punctuation unspecified unspecified unspecified unspecified unspecified  	O	null
19 שבה שב שבה verb feminine singular unspecified 3 past  	O	null
20 " " " punctuation unspecified unspecified unspecified unspecified unspecified  	O	null
21 אין אין אין noun masculine singular absolute unspecified unspecified  	O	null
22 ה ה הזמן definiteArticle unspecified unspecified unspecified unspecified unspecified 0 
22 הזמן זמן הזמן noun masculine singular absolute unspecified unspecified  	O	null
23 שם שם שם adverb unspecified unspecified unspecified unspecified unspecified  	O	null
24 כפי כפי כפי conjunction unspecified unspecified unspecified unspecified unspecified  	O	null
25 ש ש שהוא relativizer/subordinatingConjunction unspecified unspecified unspecified unspecified unspecified 0 
25 הוא הוא שהוא pronoun masculine singular unspecified 3 unspecified  	O	null
26 כאן כאן כאן adverb unspecified unspecified unspecified unspecified unspecified  	O	null
27 , , , punctuation unspecified unspecified unspecified unspecified unspecified  	O	null
28 עלפני עלפני עלפני adverb unspecified unspecified unspecified unspecified unspecified  	O	null
29 כדורהארץ כדורהארץ כדורהארץ properName unspecified unspecified unspecified unspecified unspecified  	I_PERS	null
30 . . . punctuation unspecified unspecified unspecified unspecified unspecified  	O	null

0 כל כול כל quantifier unspecified unspecified construct unspecified unspecified  	O	null
1 שבר שבר שבר noun masculine singular absolute unspecified unspecified  	O	null
2 רגע רגע רגע noun masculine singular absolute unspecified unspecified  	O	null
3 הולך הלך הולך verb masculine singular unspecified any beinoni  	O	null
4 שם שם שם adverb unspecified unspecified unspecified unspecified unspecified  	O	null
5 על על על preposition unspecified unspecified unspecified unspecified unspecified  	O	null
6 גלגל גלגל גלגל noun masculine singular construct unspecified unspecified  	O	null
7 זמן זמן זמן noun masculine singular absolute unspecified unspecified  	O	null
8 אחר אחר אחר adjective masculine singular absolute unspecified unspecified  	O	null
9 . . . punctuation unspecified unspecified unspecified unspecified unspecified  	O	null

0 ו ו ולתושבי conjunction unspecified unspecified unspecified unspecified unspecified 0 
0 ל ל ולתושבי preposition unspecified unspecified unspecified unspecified unspecified 0 
0 תושבי תושב ולתושבי noun masculine plural construct unspecified unspecified  	O	null
1 פלנטה פלנטה פלנטה properName unspecified unspecified unspecified unspecified unspecified  	I_LOC	null
2 זו זו זו pronoun feminine singular unspecified 3 unspecified  	O	null
3 לא לא לא negation unspecified unspecified unspecified unspecified unspecified  	O	null
4 היו הוא היו copula masculine plural unspecified 2 imperative  	O	null
5 שֵמות שֵמות שֵמות adjective feminine plural absolute unspecified unspecified  	O	null
6 . . . punctuation unspecified unspecified unspecified unspecified unspecified  	O	null

0 לא לא לא negation unspecified unspecified unspecified unspecified unspecified  	O	null
1 ה ה היולהם definiteArticle unspecified unspecified unspecified unspecified unspecified 0 
1 היולהם היולהם היולהם noun masculine plural absolute unspecified unspecified  	O	null
2 הורים הורה הורים noun masculine plural absolute unspecified unspecified  	O	null
3 ו ו ולא conjunction unspecified unspecified unspecified unspecified unspecified 0 
3 לא לא ולא negation unspecified unspecified unspecified unspecified unspecified  	O	null
4 היו הוא היו copula masculine plural unspecified 2 imperative  	O	null
5 ל ל להם preposition unspecified unspecified unspecified unspecified unspecified  
5 הם הם להם pronomial masculine plural unspecified 3 unspecified 0 	O	null
6 ילדים ילד ילדים noun masculine plural absolute unspecified unspecified  	O	null
7 [ [ [ punctuation unspecified unspecified unspecified unspecified unspecified  	O	null
8 ... ... ... punctuation unspecified unspecified unspecified unspecified unspecified  	O	null
9 ] ] ] punctuation unspecified unspecified unspecified unspecified unspecified  	O	null
10 הם הוא הם pronoun masculine plural unspecified 3 unspecified  	O	null
11 לא לא לא negation unspecified unspecified unspecified unspecified unspecified  	O	null
12 חיו חיה חיו verb masculine-and-feminine plural unspecified 2 imperative  	O	null
13 לפי לפי לפי preposition unspecified unspecified unspecified unspecified unspecified  	O	null
14 ה ה החוקים definiteArticle unspecified unspecified unspecified unspecified unspecified 0 
14 החוקים חוק החוקים noun masculine plural absolute unspecified unspecified  	O	null
15 של של של shel-preposition unspecified unspecified unspecified unspecified unspecified  	O	null
16 ה ה העולם definiteArticle unspecified unspecified unspecified unspecified unspecified 0 
16 העולם עולם העולם noun masculine singular absolute unspecified unspecified  	O	null
17 כ כ כאן preposition unspecified unspecified unspecified unspecified unspecified 0 
17 אן אן כאן properName feminine singular unspecified unspecified unspecified  	I_PERS	null
18 [ [ [ punctuation unspecified unspecified unspecified unspecified unspecified  	O	null
19 ... ... ... punctuation unspecified unspecified unspecified unspecified unspecified  	O	null
20 ] ] ] punctuation unspecified unspecified unspecified unspecified unspecified  	O	null
21 נשמו נשם נשמו verb masculine-and-feminine plural unspecified 2 imperative  	O	null
22 לפי לפי לפי preposition unspecified unspecified unspecified unspecified unspecified  	O	null
23 חוקי חוק חוקי noun masculine plural construct unspecified unspecified  	O	null
24 טבע טבע טבע noun masculine singular construct unspecified unspecified  	O	null
25 אחרים אחר אחרים adjective masculine plural absolute unspecified unspecified  	O	null
26 [ [ [ punctuation unspecified unspecified unspecified unspecified unspecified  	O	null
27 ... ... ... punctuation unspecified unspecified unspecified unspecified unspecified  	O	null
28 ] ] ] punctuation unspecified unspecified unspecified unspecified unspecified  	O	null
29 " " " punctuation unspecified unspecified unspecified unspecified unspecified  	O	null
30 . . . punctuation unspecified unspecified unspecified unspecified unspecified  	O	null
31 " " " punctuation unspecified unspecified unspecified unspecified unspecified  	O	null
32 פלנטה פלנטה פלנטה properName unspecified unspecified unspecified unspecified unspecified  	I_ORG	null
33 אחרת אחר אחרת adjective feminine singular absolute unspecified unspecified  	O	null
34 " " " punctuation unspecified unspecified unspecified unspecified unspecified  	O	null
35 , , , punctuation unspecified unspecified unspecified unspecified unspecified  	O	null
36 ה ה המושג definiteArticle unspecified unspecified unspecified unspecified unspecified 0 
36 המושג מושג המושג noun masculine singular absolute unspecified unspecified  	O	null
37 ש ש שיצר relativizer/subordinatingConjunction unspecified unspecified unspecified unspecified unspecified 0 
37 יצר ייצר שיצר verb masculine singular unspecified 3 past  	O	null
38 , , , punctuation unspecified unspecified unspecified unspecified unspecified  	O	null
39 מציג הציג מציג verb masculine singular unspecified any beinoni  	O	null
40 את את את at-preposition unspecified unspecified unspecified unspecified unspecified  	O	null
41 אושוויץ אושוויץ אושוויץ properName unspecified unspecified unspecified unspecified unspecified  	I_LOC	null
42 כ כ ככוכב preposition unspecified unspecified unspecified unspecified unspecified 0 
42 כוכב כוכב ככוכב noun masculine singular construct unspecified unspecified  	O	null
43 לכת לכת לכת noun feminine singular construct unspecified unspecified  	O	null
44 אחר איחר אחר verb masculine singular unspecified 2 imperative  	O	null
45 , , , punctuation unspecified unspecified unspecified unspecified unspecified  	O	null
46 ש ש ששררו relativizer/subordinatingConjunction unspecified unspecified unspecified unspecified unspecified 0 
46 שררו שרר ששררו verb masculine-and-feminine plural unspecified 3 past  	O	null
47 ב ב בו preposition unspecified unspecified unspecified unspecified unspecified  
47 ו ו בו pronomial masculine singular unspecified 3 unspecified 0 	O	null
48 חוקים חוק חוקים noun masculine plural absolute unspecified unspecified  	O	null
49 משל השלה משלו participle masculine singular unspecified any unspecified  
49 ו ו משלו possessive masculine singular unspecified 3 unspecified 0 	O	null
50 , , , punctuation unspecified unspecified unspecified unspecified unspecified  	O	null
51 ש ש שאינם relativizer/subordinatingConjunction unspecified unspecified unspecified unspecified unspecified 0 
51 אינם הוא שאינם copula masculine plural unspecified 3 beinoni  	O	null
52 תקפים תקף תקפים adjective masculine plural absolute unspecified unspecified  	O	null
53 ב ב בשום preposition unspecified unspecified unspecified unspecified unspecified 0 
53 שום שום בשום properName unspecified unspecified unspecified unspecified unspecified  	I_PERS	null
54 מקום מקום מקום noun masculine singular construct unspecified unspecified  	O	null
55 אחר איחר אחר verb masculine singular unspecified 2 imperative  	O	null
56 , , , punctuation unspecified unspecified unspecified unspecified unspecified  	O	null
57 ו ו והוא conjunction unspecified unspecified unspecified unspecified unspecified 0 
57 הוא הוא והוא pronoun masculine singular unspecified 3 unspecified  	O	null
58 , , , punctuation unspecified unspecified unspecified unspecified unspecified  	O	null
59 ה ה הניצול definiteArticle unspecified unspecified unspecified unspecified unspecified 0 
59 הניצול ניצול הניצול noun masculine singular absolute unspecified unspecified  	O	null
60 משם משם משם adverb unspecified unspecified unspecified unspecified unspecified  	O	null
61 , , , punctuation unspecified unspecified unspecified unspecified unspecified  	O	null
62 מחויב חויב מחויב verb masculine singular unspecified any beinoni  	O	null
63 לספר סיפר לספר verb unspecified unspecified unspecified unspecified infinitive  	O	null
64 את את את at-preposition unspecified unspecified unspecified unspecified unspecified  	O	null
65 הכרוניקה הכרוניקה הכרוניקה properName unspecified unspecified unspecified unspecified unspecified  	I_PERS	null
66 של של שלו shel-preposition unspecified unspecified unspecified unspecified unspecified  
66 ו ו שלו pronomial masculine singular unspecified 3 unspecified 0 	O	null
67 . . . punctuation unspecified unspecified unspecified unspecified unspecified  	O	null

0 ה ה המושג definiteArticle unspecified unspecified unspecified unspecified unspecified 0 
0 המושג מושג המושג noun masculine singular absolute unspecified unspecified  	O	null
1 מופיע הופיע מופיע verb masculine singular unspecified any beinoni  	O	null
2 לראשונה לראשונה לראשונה adverb unspecified unspecified unspecified unspecified unspecified  	O	null
3 ב ב בפרק preposition unspecified unspecified unspecified unspecified unspecified 0 
3 פרק פארק בפרק noun masculine singular construct unspecified unspecified  	O	null
4 ###NUMBER### ###NUMBER### ###NUMBER### numeral unspecified unspecified unspecified unspecified unspecified  	O	null
5 ב ב בספרו preposition unspecified unspecified unspecified unspecified unspecified 0 
5 ספר ספר בספרו noun masculine singular absolute unspecified unspecified  
5 ו ו בספרו possessive masculine singular unspecified 3 unspecified 0 	O	null
6 סלמנדרה סלמנדרה סלמנדרה noun feminine singular absolute unspecified unspecified  	O	null
7 טרם טרם טרם adverb unspecified unspecified unspecified unspecified unspecified  	O	null
8 עדות עדות עדותו noun feminine singular absolute unspecified unspecified  
8 ו ו עדותו possessive masculine singular unspecified 3 unspecified 0 	O	null
9 ב ב במשפט preposition unspecified unspecified unspecified unspecified unspecified 0 
9 ה ה במשפט definiteArticle unspecified unspecified unspecified unspecified unspecified 0 
9 המשפט משפט במשפט noun masculine singular absolute unspecified unspecified  	O	null
10 . . . punctuation unspecified unspecified unspecified unspecified unspecified  	O	null

0 ה ה הכינוי definiteArticle unspecified unspecified unspecified unspecified unspecified 0 
0 הכינוי כינוי הכינוי noun masculine singular absolute unspecified unspecified  	O	null
1 " " " punctuation unspecified unspecified unspecified unspecified unspecified  	O	null
2 פלנטה פלנטה פלנטה properName unspecified unspecified unspecified unspecified unspecified  	I_ORG	null
3 אחרת אחר אחרת adjective feminine singular absolute unspecified unspecified  	O	null
4 " " " punctuation unspecified unspecified unspecified unspecified unspecified  	O	null
5 הפך הפך הפך verb masculine singular unspecified 3 past  	O	null
6 מאז מאז מאז adverb unspecified unspecified unspecified unspecified unspecified  	O	null
7 ל ל למושג preposition unspecified unspecified unspecified unspecified unspecified 0 
7 מושג מושג למושג noun masculine singular absolute unspecified unspecified  	O	null
8 מרכזי מרכזי מרכזי adjective masculine singular absolute unspecified unspecified  	O	null
9 ב ב בהתייחסות preposition unspecified unspecified unspecified unspecified unspecified 0 
9 התייחסות התייחסות בהתייחסות noun feminine singular absolute unspecified unspecified  	O	null
10 ל ל לשואה preposition unspecified unspecified unspecified unspecified unspecified 0 
10 ה ה לשואה definiteArticle unspecified unspecified unspecified unspecified unspecified 0 
10 השואה שואה לשואה noun feminine singular absolute unspecified unspecified  	O	null
11 ו ו ומוכר conjunction unspecified unspecified unspecified unspecified unspecified 0 
11 מוכר מכר ומוכר verb masculine singular unspecified any beinoni  	O	null
12 ב ב בעולם preposition unspecified unspecified unspecified unspecified unspecified 0 
12 ה ה בעולם definiteArticle unspecified unspecified unspecified unspecified unspecified 0 
12 העולם עולם בעולם noun masculine singular absolute unspecified unspecified  	O	null
13 כול כול כולו quantifier unspecified unspecified unspecified unspecified unspecified  
13 ו ו כולו pronomial masculine singular unspecified 3 unspecified 0 	O	null
14 , , , punctuation unspecified unspecified unspecified unspecified unspecified  	O	null
15 לא לא לא negation unspecified unspecified unspecified unspecified unspecified  	O	null
16 פחות פחות פחות adverb unspecified unspecified unspecified unspecified unspecified  	O	null
17 מ מ מהצהרתו preposition unspecified unspecified unspecified unspecified unspecified 0 
17 הצהרת הצהרה מהצהרתו noun feminine singular absolute unspecified unspecified  
17 ו ו מהצהרתו possessive masculine singular unspecified 3 unspecified 0 	O	null
18 של של של shel-preposition unspecified unspecified unspecified unspecified unspecified  	O	null
19 ה ה הפילוסוף definiteArticle unspecified unspecified unspecified unspecified unspecified 0 
19 הפילוסוף פילוסוף הפילוסוף adjective masculine singular absolute unspecified unspecified  	O	null
20 אדורנו אדורנו אדורנו properName unspecified unspecified unspecified unspecified unspecified  	I_PERS	null
21 , , , punctuation unspecified unspecified unspecified unspecified unspecified  	O	null
22 ש ש שאחרי relativizer/subordinatingConjunction unspecified unspecified unspecified unspecified unspecified 0 
22 אחרי אחרי שאחרי preposition unspecified unspecified unspecified unspecified unspecified  	O	null
23 אושוויץ אושוויץ אושוויץ properName unspecified unspecified unspecified unspecified unspecified  	I_LOC	null
24 כתיבת כתיבה כתיבת noun feminine singular construct unspecified unspecified  	O	null
25 שירה שירה שירה noun feminine singular absolute unspecified unspecified  	O	null
26 היא הוא היא pronoun feminine singular unspecified 3 unspecified  	O	null
27 מעשה מעשה מעשה noun masculine singular absolute unspecified unspecified  	O	null
28 ברברי ברברי ברברי adjective masculine singular absolute unspecified unspecified  	O	null
29 . . . punctuation unspecified unspecified unspecified unspecified unspecified  	O	null

0 עדות עדות עדותו noun feminine singular absolute unspecified unspecified  
0 ו ו עדותו possessive masculine singular unspecified 3 unspecified 0 	O	null
1 היא הוא היא pronoun feminine singular unspecified 3 unspecified  	O	null
2 ה ה הטקסט definiteArticle unspecified unspecified unspecified unspecified unspecified 0 
2 הטקסט טקסט הטקסט noun masculine singular absolute unspecified unspecified  	O	null
3 ה ה המצוטט definiteArticle unspecified unspecified unspecified unspecified unspecified 0 
3 המצוטט מצוטט המצוטט adjective masculine singular absolute unspecified unspecified  	O	null
4 ו ו והזכור conjunction unspecified unspecified unspecified unspecified unspecified 0 
4 ה ה והזכור definiteArticle unspecified unspecified unspecified unspecified unspecified 0 
4 הזכור זכור והזכור adjective masculine singular absolute unspecified unspecified  	O	null
5 ביותר ביותר ביותר adverb unspecified unspecified unspecified unspecified unspecified  	O	null
6 מ מ ממשפט preposition unspecified unspecified unspecified unspecified unspecified 0 
6 משפט משפט ממשפט noun masculine singular construct unspecified unspecified  	I_LOC	null
7 אייכמן אייכמן אייכמן properName unspecified unspecified unspecified unspecified unspecified  	I_LOC	null
8 . . . punctuation unspecified unspecified unspecified unspecified unspecified  	O	null

0 חיים חיים חיים properName unspecified unspecified unspecified unspecified unspecified  	I_PERS	null
1 גורי גר גורי properName unspecified unspecified unspecified unspecified unspecified  	I_PERS	null
2 , , , punctuation unspecified unspecified unspecified unspecified unspecified  	O	null
3 חנה חנה חנה properName unspecified unspecified unspecified unspecified unspecified  	I_PERS	null
4 ארנדט ארנדט ארנדט properName unspecified unspecified unspecified unspecified unspecified  	I_PERS	null
5 , , , punctuation unspecified unspecified unspecified unspecified unspecified  	O	null
6 שושנה שושנה שושנה properName unspecified unspecified unspecified unspecified unspecified  	I_PERS	null
7 פלמן פלמן פלמן properName unspecified unspecified unspecified unspecified unspecified  	I_PERS	null
8 , , , punctuation unspecified unspecified unspecified unspecified unspecified  	O	null
9 חנה חנה חנה properName unspecified unspecified unspecified unspecified unspecified  	I_PERS	null
10 יבלונקה יבלונקה יבלונקה properName unspecified unspecified unspecified unspecified unspecified  	I_PERS	null
11 ו ו ואחרים conjunction unspecified unspecified unspecified unspecified unspecified 0 
11 אחרים אחר ואחרים adjective masculine plural absolute unspecified unspecified  	O	null
12 – – – punctuation unspecified unspecified unspecified unspecified unspecified  	O	null
13 כולם כולם כולם pronoun masculine plural unspecified 3 unspecified  	O	null
14 עסקו עסק עסקו verb masculine-and-feminine plural unspecified 3 past  	O	null
15 ב ב בספריהם preposition unspecified unspecified unspecified unspecified unspecified 0 
15 ספרי ספר בספריהם noun masculine plural absolute unspecified unspecified  
15 הם הם בספריהם possessive masculine plural unspecified 3 unspecified 0 	O	null
16 ב ב בעדותו preposition unspecified unspecified unspecified unspecified unspecified 0 
16 עדות עדות בעדותו noun feminine singular absolute unspecified unspecified  
16 ו ו בעדותו possessive masculine singular unspecified 3 unspecified 0 	O	null
17 ו ו וברישומה conjunction unspecified unspecified unspecified unspecified unspecified 0 
17 ב ב וברישומה preposition unspecified unspecified unspecified unspecified unspecified 0 
17 רישום רישום וברישומה noun masculine singular absolute unspecified unspecified  
17 ה ה וברישומה possessive feminine singular unspecified 3 unspecified 0 	O	null
18 על על על preposition unspecified unspecified unspecified unspecified unspecified  	O	null
19 ה ה המשפט definiteArticle unspecified unspecified unspecified unspecified unspecified 0 
19 המשפט משפט המשפט noun masculine singular absolute unspecified unspecified  	O	null
20 ו ו ועל conjunction unspecified unspecified unspecified unspecified unspecified 0 
20 על על ועל preposition unspecified unspecified unspecified unspecified unspecified  	O	null
21 הבנת הבנה הבנת noun feminine singular construct unspecified unspecified  	O	null
22 ה ה הטראומה definiteArticle unspecified unspecified unspecified unspecified unspecified 0 
22 הטראומה טראומה הטראומה noun feminine singular absolute unspecified unspecified  	O	null
23 ש ש שהיתה relativizer/subordinatingConjunction unspecified unspecified unspecified unspecified unspecified 0 
23 היתה הוא שהיתה copula feminine singular unspecified 3 past  	O	null
24 כרוכה כרוך כרוכה adjective feminine singular absolute unspecified unspecified  	O	null
25 בשואה.גם בשואה.גם בשואה.גם adjective masculine singular construct unspecified unspecified  	O	null
26 ה ה התובע definiteArticle unspecified unspecified unspecified unspecified unspecified 0 
26 התובע תובע התובע noun masculine singular absolute unspecified unspecified  	O	null
27 ב ב במשפט preposition unspecified unspecified unspecified unspecified unspecified 0 
27 ה ה במשפט definiteArticle unspecified unspecified unspecified unspecified unspecified 0 
27 המשפט משפט במשפט noun masculine singular absolute unspecified unspecified  	O	null
28 , , , punctuation unspecified unspecified unspecified unspecified unspecified  	O	null
29 גדעון גדעון גדעון properName unspecified unspecified unspecified unspecified unspecified  	I_PERS	null
30 ה ה האוזנר definiteArticle unspecified unspecified unspecified unspecified unspecified 0 
30 האוזנר האוזנר האוזנר adjective masculine singular absolute unspecified unspecified  	O	null
31 , , , punctuation unspecified unspecified unspecified unspecified unspecified  	O	null
32 כותב כתב כותב verb masculine singular unspecified any beinoni  	O	null
33 ב ב בספרו preposition unspecified unspecified unspecified unspecified unspecified 0 
33 ספר ספר בספרו noun masculine singular absolute unspecified unspecified  
33 ו ו בספרו possessive masculine singular unspecified 3 unspecified 0 	O	null
34 ה ה השואה definiteArticle unspecified unspecified unspecified unspecified unspecified 0 
34 השואה שואה השואה noun feminine singular absolute unspecified unspecified  	O	null
35 ב ב בראי preposition unspecified unspecified unspecified unspecified unspecified 0 
35 ראי ראי בראי noun masculine singular construct unspecified unspecified  	O	null
36 ה ה המשפט definiteArticle unspecified unspecified unspecified unspecified unspecified 0 
36 המשפט משפט המשפט noun masculine singular absolute unspecified unspecified  	O	null
37 ( ( ( punctuation unspecified unspecified unspecified unspecified unspecified  	O	null
38 ###NUMBER### ###NUMBER### ###NUMBER### numeral unspecified unspecified unspecified unspecified unspecified  	I_DATE	null
39 ) ) ) punctuation unspecified unspecified unspecified unspecified unspecified  	O	null
40 על על על preposition unspecified unspecified unspecified unspecified unspecified  	O	null
41 ה ה ההתעלפות definiteArticle unspecified unspecified unspecified unspecified unspecified 0 
41 ההתעלפות התעלפות ההתעלפות noun feminine singular absolute unspecified unspecified  	O	null
42 של של של shel-preposition unspecified unspecified unspecified unspecified unspecified  	O	null
43 ק' ק' ק' properName unspecified unspecified unspecified unspecified unspecified  	I_PERS	null
44 צטניק צטניק צטניק verb masculine singular unspecified 3 past  	O	null
45 ב ב במשפט preposition unspecified unspecified unspecified unspecified unspecified 0 
45 ה ה במשפט definiteArticle unspecified unspecified unspecified unspecified unspecified 0 
45 המשפט משפט במשפט noun masculine singular absolute unspecified unspecified  	O	null
46 כ כ כעל preposition unspecified unspecified unspecified unspecified unspecified 0 
46 ה ה כעל definiteArticle unspecified unspecified unspecified unspecified unspecified 0 
46 העל על כעל noun masculine singular absolute unspecified unspecified  	O	null
47 רגע רגע רגע noun masculine singular absolute unspecified unspecified  	O	null
48 מכונן מכונן מכונן noun masculine singular absolute unspecified unspecified  	O	null
49 . . . punctuation unspecified unspecified unspecified unspecified unspecified  	O	null

0 אחד CARD1 אחד numeral masculine singular construct unspecified unspecified  	O	null
1 ה ה המוטיבים definiteArticle unspecified unspecified unspecified unspecified unspecified 0 
1 המוטיבים מוטיב המוטיבים noun masculine plural absolute unspecified unspecified  	O	null
2 ה ה המרכזיים definiteArticle unspecified unspecified unspecified unspecified unspecified 0 
2 המרכזיים מרכזי המרכזיים adjective masculine plural absolute unspecified unspecified  	O	null
3 ב ב בפרשנות preposition unspecified unspecified unspecified unspecified unspecified 0 
3 ה ה בפרשנות definiteArticle unspecified unspecified unspecified unspecified unspecified 0 
3 הפרשנות פרשנות בפרשנות noun feminine singular absolute unspecified unspecified  	O	null
4 ה ה המיתית definiteArticle unspecified unspecified unspecified unspecified unspecified 0 
4 המיתית מיתי המיתית adjective feminine singular absolute unspecified unspecified  	O	null
5 ש ש שנתן relativizer/subordinatingConjunction unspecified unspecified unspecified unspecified unspecified 0 
5 נתן נתן שנתן verb masculine singular unspecified 3 past  	O	null
6 ק' ק' ק' preposition unspecified unspecified unspecified unspecified unspecified  	O	null
7 צטניק צטניק צטניק noun masculine singular absolute unspecified unspecified  	O	null
8 ל ל לחייו preposition unspecified unspecified unspecified unspecified unspecified 0 
8 חיי חיים לחייו noun masculine plural absolute unspecified unspecified  
8 ו ו לחייו possessive masculine singular unspecified 3 unspecified 0 	O	null
9 הוא הוא הוא pronoun masculine singular unspecified 3 unspecified  	O	null
10 מוטיב מוטיב מוטיב noun masculine singular construct unspecified unspecified  	O	null
11 ה ה האש definiteArticle unspecified unspecified unspecified unspecified unspecified 0 
11 האש אש האש noun feminine singular absolute unspecified unspecified  	O	null
12 . . . punctuation unspecified unspecified unspecified unspecified unspecified  	O	null

0 ק' ק' ק' properName unspecified unspecified unspecified unspecified unspecified  	I_PERS	null
1 צטניק צטניק צטניק noun masculine singular absolute unspecified unspecified  	O	null
2 ראה ראה ראה verb masculine singular unspecified 3 past  	O	null
3 עצמו עצמו עצמו pronoun unspecified unspecified unspecified unspecified unspecified  
3 ו ו עצמו pronomial masculine singular unspecified 3 unspecified 0 	O	null
4 כ כ כמי preposition unspecified unspecified unspecified unspecified unspecified 0 
4 מי מי כמי interrogative unspecified unspecified unspecified unspecified unspecified  	O	null
5 ש ש שנשרף relativizer/subordinatingConjunction unspecified unspecified unspecified unspecified unspecified 0 
5 נשרף נשרף שנשרף verb masculine singular unspecified 3 past  	O	null
6 ב ב באושוויץ preposition unspecified unspecified unspecified unspecified unspecified 0 
6 אושוויץ אושוויץ באושוויץ properName unspecified unspecified unspecified unspecified unspecified  	I_LOC	null
7 , , , punctuation unspecified unspecified unspecified unspecified unspecified  	O	null
8 שם שם שם adverb unspecified unspecified unspecified unspecified unspecified  	O	null
9 איבד איבד איבד verb masculine singular unspecified 3 past  	O	null
10 את את את at-preposition unspecified unspecified unspecified unspecified unspecified  	O	null
11 זהות זהות זהותו noun feminine singular absolute unspecified unspecified  
11 ו ו זהותו possessive masculine singular unspecified 3 unspecified 0 	O	null
12 ה ה האינדיווידואלית definiteArticle unspecified unspecified unspecified unspecified unspecified 0 
12 האינדיווידואלית האינדיווידואלית האינדיווידואלית adjective feminine singular absolute unspecified unspecified  	O	null
13 , , , punctuation unspecified unspecified unspecified unspecified unspecified  	O	null
14 ו ו ונולד conjunction unspecified unspecified unspecified unspecified unspecified 0 
14 נולד נולד ונולד verb masculine singular unspecified 3 past  	O	null
15 מחדש מחדש מחדש adverb unspecified unspecified unspecified unspecified unspecified  	O	null
16 ב ב בזהות preposition unspecified unspecified unspecified unspecified unspecified 0 
16 זהות זהות בזהות noun feminine singular absolute unspecified unspecified  	O	null
17 קיבוצית קיבוצי קיבוצית adjective feminine singular absolute unspecified unspecified  	O	null
18 של של של shel-preposition unspecified unspecified unspecified unspecified unspecified  	O	null
19 כל כול כל quantifier unspecified unspecified construct unspecified unspecified  	O	null
20 אלה אלה אלה pronoun masculine-and-feminine plural unspecified 3 unspecified  	O	null
21 ש ש שנגזר relativizer/subordinatingConjunction unspecified unspecified unspecified unspecified unspecified 0 
21 נגזר נגזר שנגזר verb masculine singular unspecified 3 past  	O	null
22 גורל גורל גורלם noun masculine singular absolute unspecified unspecified  
22 ם ם גורלם possessive masculine plural unspecified 3 unspecified 0 	O	null
23 להישלח נשלח להישלח verb unspecified unspecified unspecified unspecified infinitive  	O	null
24 ל ל לקרמטוריומים preposition unspecified unspecified unspecified unspecified unspecified 0 
24 קרמטוריומים קרמטוריומים לקרמטוריומים noun masculine plural absolute unspecified unspecified  	O	null
25 . . . punctuation unspecified unspecified unspecified unspecified unspecified  	O	null

0 שינוי שינוי שינוי noun masculine singular construct unspecified unspecified  	O	null
1 שם שם שמו noun masculine singular absolute unspecified unspecified  
1 ו ו שמו possessive masculine singular unspecified 3 unspecified 0 	O	null
2 לדי ילד לדי verb feminine singular unspecified 2 imperative  	O	null
3 - - - punctuation unspecified unspecified unspecified unspecified unspecified  	I_LOC	null
4 נור נור נור properName unspecified unspecified unspecified unspecified unspecified  	I_PERS	null
5 , , , punctuation unspecified unspecified unspecified unspecified unspecified  	O	null
6 נהר נהר נהר noun masculine singular construct unspecified unspecified  	O	null
7 ה ה האש definiteArticle unspecified unspecified unspecified unspecified unspecified 0 
7 האש אש האש noun feminine singular absolute unspecified unspecified  	O	null
8 , , , punctuation unspecified unspecified unspecified unspecified unspecified  	O	null
9 מרמז רימז מרמז verb masculine singular unspecified any beinoni  	O	null
10 ל ל לאותו preposition unspecified unspecified unspecified unspecified unspecified 0 
10 אותו אותו לאותו quantifier unspecified unspecified construct unspecified unspecified  	O	null
11 סמל סמל סמל noun masculine singular absolute unspecified unspecified  	O	null
12 עצמו עצמו עצמו pronoun unspecified unspecified unspecified unspecified unspecified  
12 ו ו עצמו pronomial masculine singular unspecified 3 unspecified 0 	O	null
13 . . . punctuation unspecified unspecified unspecified unspecified unspecified  	O	null

0 את את את at-preposition unspecified unspecified unspecified unspecified unspecified  	O	null
1 שם שם שם noun masculine singular construct unspecified unspecified  	O	null
2 ספר ספר ספרו noun masculine singular absolute unspecified unspecified  
2 ו ו ספרו possessive masculine singular unspecified 3 unspecified 0 	O	null
3 ה ה הראשון definiteArticle unspecified unspecified unspecified unspecified unspecified 0 
3 הראשון ORD1 הראשון numeral masculine singular absolute unspecified unspecified  	O	null
4 סלמנדרה סלמנדרה סלמנדרה noun feminine singular absolute unspecified unspecified  	O	null
5 , , , punctuation unspecified unspecified unspecified unspecified unspecified  	O	null
6 ש ש שמשמעו relativizer/subordinatingConjunction unspecified unspecified unspecified unspecified unspecified 0 
6 משמע משמע שמשמעו noun masculine singular absolute unspecified unspecified  
6 ו ו שמשמעו possessive masculine singular unspecified 3 unspecified 0 	O	null
7 ב ב במקור preposition unspecified unspecified unspecified unspecified unspecified 0 
7 ה ה במקור definiteArticle unspecified unspecified unspecified unspecified unspecified 0 
7 המקור מקור במקור noun masculine singular absolute unspecified unspecified  	O	null
8 ה ה היווני definiteArticle unspecified unspecified unspecified unspecified unspecified 0 
8 היווני יווני היווני adjective masculine singular absolute unspecified unspecified  	O	null
9 חיה חיה חיה noun feminine singular absolute unspecified unspecified  	O	null
10 דמוית דמוי דמוית adjective feminine singular absolute unspecified unspecified  	O	null
11 לטאה לטאה לטאה noun feminine singular absolute unspecified unspecified  	O	null
12 ש ש שממשיכה relativizer/subordinatingConjunction unspecified unspecified unspecified unspecified unspecified 0 
12 ממשיכה המשיך שממשיכה verb feminine singular unspecified any beinoni  	O	null
13 לחיות חי לחיות verb unspecified unspecified unspecified unspecified infinitive  	O	null
14 גם גם גם conjunction unspecified unspecified unspecified unspecified unspecified  	O	null
15 לאחר לאחר לאחר conjunction unspecified unspecified unspecified unspecified unspecified  	O	null
16 ש ש שהיא relativizer/subordinatingConjunction unspecified unspecified unspecified unspecified unspecified 0 
16 היא הוא שהיא pronoun feminine singular unspecified 3 unspecified  	O	null
17 נשרפת נשרף נשרפת verb feminine singular unspecified any beinoni  	O	null
18 ב ב באש preposition unspecified unspecified unspecified unspecified unspecified 0 
18 אש אש באש noun feminine singular absolute unspecified unspecified  	O	null
19 , , , punctuation unspecified unspecified unspecified unspecified unspecified  	O	null
20 ו ו ושמבטאת conjunction unspecified unspecified unspecified unspecified unspecified 0 
20 ש ש ושמבטאת relativizer/subordinatingConjunction unspecified unspecified unspecified unspecified unspecified 0 
20 מבטאת ביטא ושמבטאת verb feminine singular unspecified any beinoni  	O	null
21 את את את at-preposition unspecified unspecified unspecified unspecified unspecified  	O	null
22 רעיון רעיון רעיון noun masculine singular construct unspecified unspecified  	O	null
23 ה ה ההישרדות definiteArticle unspecified unspecified unspecified unspecified unspecified 0 
23 ההישרדות הישרדות ההישרדות noun feminine singular absolute unspecified unspecified  	O	null
24 – – – punctuation unspecified unspecified unspecified unspecified unspecified  	O	null
25 קבע קבע קבע verb masculine singular unspecified 3 past  	O	null
26 ק' ק' ק' properName unspecified unspecified unspecified unspecified unspecified  	I_PERS	null
27 צטניק צטניק צטניק verb masculine singular unspecified 3 past  	O	null
28 כ כ ככותרת preposition unspecified unspecified unspecified unspecified unspecified 0 
28 ה ה ככותרת definiteArticle unspecified unspecified unspecified unspecified unspecified 0 
28 הכותרת כותרת ככותרת noun feminine singular absolute unspecified unspecified  	O	null
29 ל ל לכרוניקה preposition unspecified unspecified unspecified unspecified unspecified 0 
29 ה ה לכרוניקה definiteArticle unspecified unspecified unspecified unspecified unspecified 0 
29 הכרוניקה הכרוניקה לכרוניקה noun feminine singular absolute unspecified unspecified  	O	null
30 כול כול כולה quantifier unspecified unspecified unspecified unspecified unspecified  
30 ה ה כולה pronomial feminine singular unspecified 3 unspecified 0 	O	null
31 . . . punctuation unspecified unspecified unspecified unspecified unspecified  	O	null

0 עותקים עותק עותקים noun masculine plural absolute unspecified unspecified  	O	null
1 יחידים יחיד יחידים adjective masculine plural absolute unspecified unspecified  	O	null
2 של של של shel-preposition unspecified unspecified unspecified unspecified unspecified  	O	null
3 ספר ספר ספר noun masculine singular construct unspecified unspecified  	O	null
4 שירי שיר שיריו noun masculine plural absolute unspecified unspecified  
4 ו ו שיריו possessive masculine singular unspecified 3 unspecified 0 	O	null
5 עשרים ORD-CARD20 עשרים numeral masculine-and-feminine plural construct unspecified unspecified  	O	null
6 ו ו ושתיים conjunction unspecified unspecified unspecified unspecified unspecified 0 
6 שתיים CARD2 ושתיים numeral feminine singular absolute unspecified unspecified  	O	null
7 , , , punctuation unspecified unspecified unspecified unspecified unspecified  	O	null
8 ש ש שכאמור relativizer/subordinatingConjunction unspecified unspecified unspecified unspecified unspecified 0 
8 כ כ שכאמור preposition unspecified unspecified unspecified unspecified unspecified 0 
8 ה ה שכאמור definiteArticle unspecified unspecified unspecified unspecified unspecified 0 
8 האמור אמור שכאמור adjective masculine singular absolute unspecified unspecified  	O	null
9 פורסם פורסם פורסם verb masculine singular unspecified 3 past  	O	null
10 עוד עוד עוד adverb unspecified unspecified unspecified unspecified unspecified  	O	null
11 לפני לפני לפני preposition unspecified unspecified unspecified unspecified unspecified  	O	null
12 ה ה השואה definiteArticle unspecified unspecified unspecified unspecified unspecified 0 
12 השואה שואה השואה noun feminine singular absolute unspecified unspecified  	O	null
13 , , , punctuation unspecified unspecified unspecified unspecified unspecified  	O	null
14 ש ש שנמצאו relativizer/subordinatingConjunction unspecified unspecified unspecified unspecified unspecified 0 
14 נמצאו נמצא שנמצאו verb masculine-and-feminine plural unspecified 3 past  	O	null
15 ב ב בספריית preposition unspecified unspecified unspecified unspecified unspecified 0 
15 ספריית ספרייה בספריית noun feminine singular construct unspecified unspecified  	O	null
16 ה ה הקונגרס definiteArticle unspecified unspecified unspecified unspecified unspecified 0 
16 הקונגרס קונגרס הקונגרס noun masculine singular absolute unspecified unspecified  	O	null
17 ב ב בוושינגטון preposition unspecified unspecified unspecified unspecified unspecified 0 
17 וושינגטון ושינגטון בוושינגטון properName unspecified unspecified unspecified unspecified unspecified  	I_LOC	null
18 ו ו ובספרייה conjunction unspecified unspecified unspecified unspecified unspecified 0 
18 ב ב ובספרייה preposition unspecified unspecified unspecified unspecified unspecified 0 
18 ה ה ובספרייה definiteArticle unspecified unspecified unspecified unspecified unspecified 0 
18 הספרייה ספרייה ובספרייה noun feminine singular absolute unspecified unspecified  	O	null
19 ה ה הלאומית definiteArticle unspecified unspecified unspecified unspecified unspecified 0 
19 הלאומית לאומי הלאומית adjective feminine singular absolute unspecified unspecified  	O	null
20 ב ב בירושלים preposition unspecified unspecified unspecified unspecified unspecified 0 
20 ירושלים ירושלים בירושלים properName unspecified unspecified unspecified unspecified unspecified  	I_LOC	null
21 – – – punctuation unspecified unspecified unspecified unspecified unspecified  	O	null
22 הושמדועל הושמדועל הושמדועל properName unspecified unspecified unspecified unspecified unspecified  	I_PERS	null
23 ידו יידה ידו verb masculine-and-feminine plural unspecified 3 past  	O	null
24 ב ב בנימוק preposition unspecified unspecified unspecified unspecified unspecified 0 
24 ה ה בנימוק definiteArticle unspecified unspecified unspecified unspecified unspecified 0 
24 הנימוק נימוק בנימוק noun masculine singular absolute unspecified unspecified  	O	null
25 כי כי כי conjunction unspecified unspecified unspecified unspecified unspecified  	O	null
26 " " " punctuation unspecified unspecified unspecified unspecified unspecified  	O	null
27 ה ה הספר definiteArticle unspecified unspecified unspecified unspecified unspecified 0 
27 הספר ספר הספר noun masculine singular absolute unspecified unspecified  	O	null
28 ה ה הזה definiteArticle unspecified unspecified unspecified unspecified unspecified 0 
28 הזה זה הזה pronoun masculine singular unspecified 3 unspecified  	O	null
29 היה הוא היה copula masculine singular unspecified 3 past  	O	null
30 שייך שייך שייך adjective masculine singular absolute unspecified unspecified  	O	null
31 ל ל לעולם preposition unspecified unspecified unspecified unspecified unspecified 0 
31 ה ה לעולם definiteArticle unspecified unspecified unspecified unspecified unspecified 0 
31 העולם עולם לעולם noun masculine singular absolute unspecified unspecified  	O	null
32 ש ש שכבר relativizer/subordinatingConjunction unspecified unspecified unspecified unspecified unspecified 0 
32 כבר כבר שכבר adverb unspecified unspecified unspecified unspecified unspecified  	O	null
33 לא לא לא negation unspecified unspecified unspecified unspecified unspecified  	O	null
34 קיים קיים קיים verb masculine singular unspecified 3 past  	O	null
35 , , , punctuation unspecified unspecified unspecified unspecified unspecified  	O	null
36 ל ל לעולם preposition unspecified unspecified unspecified unspecified unspecified 0 
36 ה ה לעולם definiteArticle unspecified unspecified unspecified unspecified unspecified 0 
36 העולם עולם לעולם noun masculine singular absolute unspecified unspecified  	O	null
37 ש ש שנשרף relativizer/subordinatingConjunction unspecified unspecified unspecified unspecified unspecified 0 
37 נשרף נשרף שנשרף verb masculine singular unspecified 3 past  	O	null
38 " " " punctuation unspecified unspecified unspecified unspecified unspecified  	O	null
39 ( ( ( punctuation unspecified unspecified unspecified unspecified unspecified  	O	null
40 מ מ מירון preposition unspecified unspecified unspecified unspecified unspecified 0 
40 ירון ירון מירון properName masculine singular unspecified unspecified unspecified  	I_PERS	null
41 , , , punctuation unspecified unspecified unspecified unspecified unspecified  	O	null
42 ###NUMBER### ###NUMBER### ###NUMBER### numeral unspecified unspecified unspecified unspecified unspecified  	I_DATE	null
43 ) ) ) punctuation unspecified unspecified unspecified unspecified unspecified  	O	null
44 . . . punctuation unspecified unspecified unspecified unspecified unspecified  	O	null

0 מלבד מלבד מלבד preposition unspecified unspecified unspecified unspecified unspecified  	O	null
1 ספר ספר ספר noun masculine singular construct unspecified unspecified  	O	null
2 ה ה הפואמות definiteArticle unspecified unspecified unspecified unspecified unspecified 0 
2 הפואמות פואמה הפואמות noun feminine plural absolute unspecified unspecified  	O	null
3 כוכב כוכב כוכב noun masculine singular construct unspecified unspecified  	O	null
4 ה ה האפר definiteArticle unspecified unspecified unspecified unspecified unspecified 0 
4 האפר אפר האפר noun masculine singular absolute unspecified unspecified  	O	null
5 ש ש שפורסם relativizer/subordinatingConjunction unspecified unspecified unspecified unspecified unspecified 0 
5 פורסם פורסם שפורסם verb masculine singular unspecified 3 past  	O	null
6 ב ב בשנות preposition unspecified unspecified unspecified unspecified unspecified 0 
6 שנות שנה בשנות noun feminine plural construct unspecified unspecified  	I_DATE	null
7 ה ה השישים definiteArticle unspecified unspecified unspecified unspecified unspecified 0 
7 השישים ORD-CARD60 השישים numeral masculine-and-feminine plural absolute unspecified unspecified  	I_DATE	null
8 לא לא לא negation unspecified unspecified unspecified unspecified unspecified  	O	null
9 כתב כתב כתב verb masculine singular unspecified 3 past  	O	null
10 עוד עוד עוד adverb unspecified unspecified unspecified unspecified unspecified  	O	null
11 שירה שירה שירה noun feminine singular absolute unspecified unspecified  	O	null
12 , , , punctuation unspecified unspecified unspecified unspecified unspecified  	O	null
13 אולי אולי אולי adverb unspecified unspecified unspecified unspecified unspecified  	O	null
14 ב ב בהשראת preposition unspecified unspecified unspecified unspecified unspecified 0 
14 השראת השראה בהשראת noun feminine singular construct unspecified unspecified  	O	null
15 משפט משפט משפטו noun masculine singular absolute unspecified unspecified  
15 ו ו משפטו possessive masculine singular unspecified 3 unspecified 0 	O	null
16 ה ה המפורסם definiteArticle unspecified unspecified unspecified unspecified unspecified 0 
16 המפורסם מפורסם המפורסם adjective masculine singular absolute unspecified unspecified  	O	null
17 של של של shel-preposition unspecified unspecified unspecified unspecified unspecified  	O	null
18 אדורנו אדורנו אדורנו properName unspecified unspecified unspecified unspecified unspecified  	I_PERS	null
19 . . . punctuation unspecified unspecified unspecified unspecified unspecified  	O	null

0 ב ב ב preposition unspecified unspecified unspecified unspecified unspecified 0 	O	null
1 - - - punctuation unspecified unspecified unspecified unspecified unspecified  	O	null
2 ###NUMBER### ###NUMBER### ###NUMBER### numeral unspecified unspecified unspecified unspecified unspecified  	I_DATE	null
3 יצא יצא יצא verb masculine singular unspecified 3 past  	O	null
4 לאור לאור לאור preposition unspecified unspecified unspecified unspecified unspecified  	O	null
5 ספר ספר ספרו noun masculine singular absolute unspecified unspecified  
5 ו ו ספרו possessive masculine singular unspecified 3 unspecified 0 	O	null
6 ה ה האוטוביוגרפי definiteArticle unspecified unspecified unspecified unspecified unspecified 0 
6 האוטוביוגרפי אוטוביוגרפי האוטוביוגרפי adjective masculine singular absolute unspecified unspecified  	O	null
7 כחול כחול כחול adjective masculine singular absolute unspecified unspecified  	O	null
8 מ מ מאפר preposition unspecified unspecified unspecified unspecified unspecified 0 
8 אפר אפר מאפר noun masculine singular absolute unspecified unspecified  	O	null
9 , , , punctuation unspecified unspecified unspecified unspecified unspecified  	O	null
10 ש ש ששמו relativizer/subordinatingConjunction unspecified unspecified unspecified unspecified unspecified 0 
10 שם שם ששמו noun masculine singular absolute unspecified unspecified  
10 ו ו ששמו possessive masculine singular unspecified 3 unspecified 0 	O	null
11 הומר הומר הומר verb masculine singular unspecified 3 past  	O	null
12 מאוחר מאוחר מאוחר adverb unspecified unspecified unspecified unspecified unspecified  	O	null
13 יותר יותר יותר adverb unspecified unspecified unspecified unspecified unspecified  	O	null
14 ל ל להעימות preposition unspecified unspecified unspecified unspecified unspecified 0 
14 ה ה להעימות definiteArticle unspecified unspecified unspecified unspecified unspecified 0 
14 ההעימות עימות להעימות noun feminine singular absolute unspecified unspecified  	O	null
15 , , , punctuation unspecified unspecified unspecified unspecified unspecified  	O	null
16 ש ש שמתאר relativizer/subordinatingConjunction unspecified unspecified unspecified unspecified unspecified 0 
16 מתאר תיאר שמתאר verb masculine singular unspecified any beinoni  	O	null
17 את את את at-preposition unspecified unspecified unspecified unspecified unspecified  	O	null
18 חיי חיים חייו noun masculine plural absolute unspecified unspecified  
18 ו ו חייו possessive masculine singular unspecified 3 unspecified 0 	O	null
19 ו ו וחיי conjunction unspecified unspecified unspecified unspecified unspecified 0 
19 חיי חיים וחיי noun masculine plural construct unspecified unspecified  	O	null
20 משפחת משפחה משפחתו noun feminine singular absolute unspecified unspecified  
20 ו ו משפחתו possessive masculine singular unspecified 3 unspecified 0 	O	null
21 ה ה החדשה definiteArticle unspecified unspecified unspecified unspecified unspecified 0 
21 החדשה חדש החדשה adjective feminine singular absolute unspecified unspecified  	O	null
22 ב ב בארץ preposition unspecified unspecified unspecified unspecified unspecified 0 
22 ה ה בארץ definiteArticle unspecified unspecified unspecified unspecified unspecified 0 
22 הארץ ארץ בארץ noun feminine singular absolute unspecified unspecified  	O	null
23 ו ו ומתייחס conjunction unspecified unspecified unspecified unspecified unspecified 0 
23 מתייחס התייחס ומתייחס verb masculine singular unspecified any beinoni  	O	null
24 גם גם גם conjunction unspecified unspecified unspecified unspecified unspecified  	O	null
25 ל ל לקונפליקט preposition unspecified unspecified unspecified unspecified unspecified 0 
25 ה ה לקונפליקט definiteArticle unspecified unspecified unspecified unspecified unspecified 0 
25 הקונפליקט קונפליקט לקונפליקט noun masculine singular absolute unspecified unspecified  	O	null
26 ה ה הישראלי definiteArticle unspecified unspecified unspecified unspecified unspecified 0 
26 הישראלי ישראלי הישראלי adjective masculine singular absolute unspecified unspecified  	O	null
27 - - - punctuation unspecified unspecified unspecified unspecified unspecified  	O	null
28 ערבי ערבי ערבי adjective masculine singular absolute unspecified unspecified  	O	null
29 . . . punctuation unspecified unspecified unspecified unspecified unspecified  	O	null

0 ספר ספר ספרו noun masculine singular absolute unspecified unspecified  
0 ו ו ספרו possessive masculine singular unspecified 3 unspecified 0 	O	null
1 ה ה האחרון definiteArticle unspecified unspecified unspecified unspecified unspecified 0 
1 האחרון אחרון האחרון adjective masculine singular absolute unspecified unspecified  	O	null
2 , , , punctuation unspecified unspecified unspecified unspecified unspecified  	O	null
3 צופן צופן צופן noun masculine singular construct unspecified unspecified  	O	null
4 א.ד.מ.ע.(אותיות א.ד.מ.ע.(אותיות א.ד.מ.ע.(אותיות adjective feminine plural construct unspecified unspecified  	O	null
5 אלה אל אלה noun feminine singular absolute unspecified unspecified  	O	null
6 מופיעות הופיע מופיעות verb feminine plural unspecified any beinoni  	O	null
7 גם גם גם conjunction unspecified unspecified unspecified unspecified unspecified  	O	null
8 ב ב בראש preposition unspecified unspecified unspecified unspecified unspecified 0 
8 ראש ראש בראש noun masculine singular construct unspecified unspecified  	O	null
9 כל כול כל quantifier unspecified unspecified construct unspecified unspecified  	O	null
10 אחד CARD1 אחד numeral masculine singular absolute unspecified unspecified  	O	null
11 מ מ מספריו preposition unspecified unspecified unspecified unspecified unspecified 0 
11 ספרי ספר מספריו noun masculine plural absolute unspecified unspecified  
11 ו ו מספריו possessive masculine singular unspecified 3 unspecified 0 	O	null
12 ה ה הקודמים definiteArticle unspecified unspecified unspecified unspecified unspecified 0 
12 הקודמים קודם הקודמים adjective masculine plural absolute unspecified unspecified  	O	null
13 ) ) ) punctuation unspecified unspecified unspecified unspecified unspecified  	O	null
14 מ מ מ preposition unspecified unspecified unspecified unspecified unspecified 0 	O	null
15 - - - punctuation unspecified unspecified unspecified unspecified unspecified  	O	null
16 , , , punctuation unspecified unspecified unspecified unspecified unspecified  	O	null
17 ###NUMBER### ###NUMBER### ###NUMBER### numeral unspecified unspecified unspecified unspecified unspecified  	I_DATE	null
18 ש ש שכותרת relativizer/subordinatingConjunction unspecified unspecified unspecified unspecified unspecified 0 
18 כותרת כותרת שכותרת noun feminine singular construct unspecified unspecified  	O	null
19 ה ה המשנה definiteArticle unspecified unspecified unspecified unspecified unspecified 0 
19 המשנה משנה המשנה noun feminine singular absolute unspecified unspecified  	O	null
20 של של שלו shel-preposition unspecified unspecified unspecified unspecified unspecified  
20 ו ו שלו pronomial masculine singular unspecified 3 unspecified 0 	O	null
21 " " " punctuation unspecified unspecified unspecified unspecified unspecified  	O	null
22 משא משא משא noun masculine singular construct unspecified unspecified  	O	null
23 ה ה הגרעין definiteArticle unspecified unspecified unspecified unspecified unspecified 0 
23 הגרעין גרעין הגרעין noun masculine singular absolute unspecified unspecified  	O	null
24 על על על preposition unspecified unspecified unspecified unspecified unspecified  	O	null
25 אושוויץ אושוויץ אושוויץ properName unspecified unspecified unspecified unspecified unspecified  	I_LOC	null
26 " " " punctuation unspecified unspecified unspecified unspecified unspecified  	O	null
27 , , , punctuation unspecified unspecified unspecified unspecified unspecified  	O	null
28 חריג חריג חריג adjective masculine singular absolute unspecified unspecified  	O	null
29 ו ו ושונה conjunction unspecified unspecified unspecified unspecified unspecified 0 
29 שונה שונה ושונה adjective masculine singular absolute unspecified unspecified  	O	null
30 מ מ מספריו preposition unspecified unspecified unspecified unspecified unspecified 0 
30 ספרי ספר מספריו noun masculine plural absolute unspecified unspecified  
30 ו ו מספריו possessive masculine singular unspecified 3 unspecified 0 	O	null
31 ה ה האחרים definiteArticle unspecified unspecified unspecified unspecified unspecified 0 
31 האחרים אחר האחרים adjective masculine plural absolute unspecified unspecified  	O	null
32 . . . punctuation unspecified unspecified unspecified unspecified unspecified  	O	null

0 ה ה הספר definiteArticle unspecified unspecified unspecified unspecified unspecified 0 
0 הספר ספר הספר noun masculine singular absolute unspecified unspecified  	O	null
1 נכתב נכתב נכתב verb masculine singular unspecified 3 past  	O	null
2 בעקבות בעקבות בעקבות preposition unspecified unspecified unspecified unspecified unspecified  	O	null
3 טיפול טיפול טיפול noun masculine singular absolute unspecified unspecified  	O	null
4 ש ש שקיבל relativizer/subordinatingConjunction unspecified unspecified unspecified unspecified unspecified 0 
4 קיבל קיבל שקיבל verb masculine singular unspecified 3 past  	O	null
5 ב ב בהולנד preposition unspecified unspecified unspecified unspecified unspecified 0 
5 הולנד הולנד בהולנד properName unspecified unspecified unspecified unspecified unspecified  	I_LOC	null
6 מ מ מפסיכיאטר preposition unspecified unspecified unspecified unspecified unspecified 0 
6 פסיכיאטר פסיכיאטר מפסיכיאטר noun masculine singular absolute unspecified unspecified  	O	null
7 הולנדי הולנדי הולנדי adjective masculine singular absolute unspecified unspecified  	O	null
8 ש ש שהתמחה relativizer/subordinatingConjunction unspecified unspecified unspecified unspecified unspecified 0 
8 התמחה התמחה שהתמחה verb masculine singular unspecified 3 past  	O	null
9 ב ב בטיפול preposition unspecified unspecified unspecified unspecified unspecified 0 
9 טיפול טיפול בטיפול noun masculine singular absolute unspecified unspecified  	O	null
10 ב ב בניצולי preposition unspecified unspecified unspecified unspecified unspecified 0 
10 ניצולי ניצול בניצולי noun masculine plural construct unspecified unspecified  	O	null
11 שואה שואה שואה noun feminine singular absolute unspecified unspecified  	O	null
12 באמצעות באמצעות באמצעות preposition unspecified unspecified unspecified unspecified unspecified  	O	null
13 ה ה הסם definiteArticle unspecified unspecified unspecified unspecified unspecified 0 
13 הסם סם הסם noun masculine singular absolute unspecified unspecified  	O	null
14 אל אל אל properName unspecified unspecified unspecified unspecified unspecified  	I_LOC	null
15 - - - properName unspecified unspecified unspecified unspecified unspecified  	I_LOC	null
16 אס אס אס properName unspecified unspecified unspecified unspecified unspecified  	I_LOC	null
17 - - - punctuation unspecified unspecified unspecified unspecified unspecified  	O	null
18 די די די adverb unspecified unspecified unspecified unspecified unspecified  	O	null
19 . . . punctuation unspecified unspecified unspecified unspecified unspecified  	O	null

0 מבלי מבלי מבלי conjunction unspecified unspecified unspecified unspecified unspecified  	O	null
1 להסביר הסביר להסביר verb unspecified unspecified unspecified unspecified infinitive  	O	null
2 מה מה מה interrogative unspecified unspecified unspecified unspecified unspecified  	O	null
3 משמעות משמעות משמעות noun feminine singular construct unspecified unspecified  	O	null
4 ה ה האותיות definiteArticle unspecified unspecified unspecified unspecified unspecified 0 
4 האותיות אות האותיות noun feminine plural absolute unspecified unspecified  	O	null
5 ש ש שבכותרת relativizer/subordinatingConjunction unspecified unspecified unspecified unspecified unspecified 0 
5 ב ב שבכותרת preposition unspecified unspecified unspecified unspecified unspecified 0 
5 כותרת כותרת שבכותרת noun feminine singular construct unspecified unspecified  	O	null
6 ספר ספר ספרו noun masculine singular absolute unspecified unspecified  
6 ו ו ספרו possessive masculine singular unspecified 3 unspecified 0 	O	null
7 , , , punctuation unspecified unspecified unspecified unspecified unspecified  	O	null
8 ק' ק' ק' verb masculine singular unspecified 3 past  	O	null
9 צטניק צטניק צטניק noun masculine singular absolute unspecified unspecified  	O	null
10 טען טען טען verb masculine singular unspecified 3 past  	O	null
11 כי כי כי conjunction unspecified unspecified unspecified unspecified unspecified  	O	null
12 אלה אלה אלה pronoun masculine-and-feminine plural unspecified 3 unspecified  	O	null
13 הצילו הציל הצילו verb masculine-and-feminine plural unspecified 3 past  	O	null
14 את את את at-preposition unspecified unspecified unspecified unspecified unspecified  	O	null
15 חיי חיים חייו noun masculine plural absolute unspecified unspecified  
15 ו ו חייו possessive masculine singular unspecified 3 unspecified 0 	O	null
16 ב ב באושוויץ preposition unspecified unspecified unspecified unspecified unspecified 0 
16 אושוויץ אושוויץ באושוויץ properName unspecified unspecified unspecified unspecified unspecified  	I_LOC	null
17 . . . punctuation unspecified unspecified unspecified unspecified unspecified  	O	null

0 ש ש שיינטוך relativizer/subordinatingConjunction unspecified unspecified unspecified unspecified unspecified 0 
0 יינטוך יינטוך שיינטוך properName unspecified unspecified unspecified unspecified unspecified  	I_PERS	null
1 טוען טען טוען verb masculine singular unspecified any beinoni  	O	null
2 ב ב בספרו preposition unspecified unspecified unspecified unspecified unspecified 0 
2 ספר ספר בספרו noun masculine singular absolute unspecified unspecified  
2 ו ו בספרו possessive masculine singular unspecified 3 unspecified 0 	O	null
3 כי כי כי conjunction unspecified unspecified unspecified unspecified unspecified  	O	null
4 אלה אלה אלה pronoun masculine-and-feminine plural unspecified 3 unspecified  	O	null
5 ראשי ראש ראשי noun masculine plural construct unspecified unspecified  	O	null
6 תיבות תיבה תיבות noun feminine plural absolute unspecified unspecified  	O	null
7 של של של shel-preposition unspecified unspecified unspecified unspecified unspecified  	O	null
8 ה ה התפילה definiteArticle unspecified unspecified unspecified unspecified unspecified 0 
8 התפילה תפילה התפילה noun feminine singular absolute unspecified unspecified  	O	null
9 " " " punctuation unspecified unspecified unspecified unspecified unspecified  	O	null
10 אלהא אלהא אלהא verb masculine singular unspecified 3 past  	O	null
11 דמאי דמאי דמאיר noun masculine singular absolute unspecified unspecified  
11 ו ו דמאיר possessive masculine singular unspecified 3 unspecified 0 	O	null
12 ענני ענן ענני noun masculine plural construct unspecified unspecified  	O	null
13 " " " punctuation unspecified unspecified unspecified unspecified unspecified  	O	null
14 , , , punctuation unspecified unspecified unspecified unspecified unspecified  	O	null
15 ש ש שנחשבת relativizer/subordinatingConjunction unspecified unspecified unspecified unspecified unspecified 0 
15 נחשבת נחשב שנחשבת verb feminine singular unspecified any beinoni  	O	null
16 כ כ כתפילת preposition unspecified unspecified unspecified unspecified unspecified 0 
16 תפילת תפילה כתפילת noun feminine singular construct unspecified unspecified  	O	null
17 הצלה הצלה הצלה noun feminine singular absolute unspecified unspecified  	O	null
18 מאגית מגיה מאגית noun feminine singular construct unspecified unspecified  	O	null
19 ו ו ומופנית conjunction unspecified unspecified unspecified unspecified unspecified 0 
19 מופנית הופנה ומופנית verb feminine singular unspecified any beinoni  	O	null
20 ל ל לתנא preposition unspecified unspecified unspecified unspecified unspecified 0 
20 תנא תנא לתנא noun masculine singular construct unspecified unspecified  	O	null
21 רבי רבי רבי noun masculine singular construct unspecified unspecified  	O	null
22 מאיר מאיר מאיר properName unspecified unspecified unspecified unspecified unspecified  	I_PERS	null
23 . . . punctuation unspecified unspecified unspecified unspecified unspecified  	O	null

0 ב ב בספר preposition unspecified unspecified unspecified unspecified unspecified 0 
0 ה ה בספר definiteArticle unspecified unspecified unspecified unspecified unspecified 0 
0 הספר ספר בספר noun masculine singular absolute unspecified unspecified  	O	null
1 מתוארות תואר מתוארות verb feminine plural unspecified any beinoni  	O	null
2 תחושות תחושה תחושותיו noun feminine plural absolute unspecified unspecified  
2 ו ו תחושותיו possessive masculine singular unspecified 3 unspecified 0 	O	null
3 ב ב באושוויץ preposition unspecified unspecified unspecified unspecified unspecified 0 
3 אושוויץ אושוויץ באושוויץ properName unspecified unspecified unspecified unspecified unspecified  	I_LOC	null
4 מתוך מתוך מתוך preposition unspecified unspecified unspecified unspecified unspecified  	O	null
5 נקודת נקודה נקודת noun feminine singular construct unspecified unspecified  	O	null
6 מבט מבט מבט noun masculine singular absolute unspecified unspecified  	O	null
7 רטרוספקטיבית רטרוספקטיבית רטרוספקטיבית adjective feminine singular absolute unspecified unspecified  	O	null
8 , , , punctuation unspecified unspecified unspecified unspecified unspecified  	O	null
9 כפי כפי כפי conjunction unspecified unspecified unspecified unspecified unspecified  	O	null
10 ש ש שחווה relativizer/subordinatingConjunction unspecified unspecified unspecified unspecified unspecified 0 
10 חווה חווה שחווה verb masculine singular unspecified 3 past  	O	null
11 את את אותן at-preposition unspecified unspecified unspecified unspecified unspecified  
11 הן הן אותן pronomial feminine plural unspecified 3 unspecified 0 	O	null
12 מחדש מחדש מחדש adverb unspecified unspecified unspecified unspecified unspecified  	O	null
13 ב ב בהשפעת preposition unspecified unspecified unspecified unspecified unspecified 0 
13 השפעת השפעה בהשפעת noun feminine singular construct unspecified unspecified  	O	null
14 ה ה הסם definiteArticle unspecified unspecified unspecified unspecified unspecified 0 
14 הסם סם הסם noun masculine singular absolute unspecified unspecified  	O	null
15 . . . punctuation unspecified unspecified unspecified unspecified unspecified  	O	null

0 ה ה הספר definiteArticle unspecified unspecified unspecified unspecified unspecified 0 
0 הספר ספר הספר noun masculine singular absolute unspecified unspecified  	O	null
1 כול כול כולו quantifier unspecified unspecified unspecified unspecified unspecified  
1 ו ו כולו pronomial masculine singular unspecified 3 unspecified 0 	O	null
2 אפוף אפף אפוף participle masculine singular absolute any unspecified  	O	null
3 ב ב באווירה preposition unspecified unspecified unspecified unspecified unspecified 0 
3 אווירה אווירה באווירה noun feminine singular absolute unspecified unspecified  	O	null
4 מיסטית מיסטי מיסטית adjective feminine singular absolute unspecified unspecified  	O	null
5 ו ו ומשובץ conjunction unspecified unspecified unspecified unspecified unspecified 0 
5 משובץ שובץ ומשובץ verb masculine singular unspecified any beinoni  	O	null
6 ב ב בדימויים preposition unspecified unspecified unspecified unspecified unspecified 0 
6 דימויים דימוי בדימויים noun masculine plural absolute unspecified unspecified  	O	null
7 קבליים קבליים קבליים adjective masculine plural absolute unspecified unspecified  	O	null
8 . . . punctuation unspecified unspecified unspecified unspecified unspecified  	O	null

0 ה ה הטקסט definiteArticle unspecified unspecified unspecified unspecified unspecified 0 
0 הטקסט טקסט הטקסט noun masculine singular absolute unspecified unspecified  	O	null
1 הופיע הופיע הופיע verb masculine singular unspecified 3 past  	O	null
2 לראשונה לראשונה לראשונה adverb unspecified unspecified unspecified unspecified unspecified  	O	null
3 ב ב בהעולם preposition unspecified unspecified unspecified unspecified unspecified 0 
3 ה ה בהעולם definiteArticle unspecified unspecified unspecified unspecified unspecified 0 
3 ההעולם עולם בהעולם noun masculine singular absolute unspecified unspecified  	O	null
4 ה ה הזה definiteArticle unspecified unspecified unspecified unspecified unspecified 0 
4 הזה זה הזה pronoun masculine singular unspecified 3 unspecified  	O	null
5 ש ש שהקדיש relativizer/subordinatingConjunction unspecified unspecified unspecified unspecified unspecified 0 
5 הקדיש הקדיש שהקדיש verb masculine singular unspecified 3 past  	O	null
6 ל ל לו preposition unspecified unspecified unspecified unspecified unspecified  
6 ו ו לו pronomial masculine singular unspecified 3 unspecified 0 	O	null
7 גיליון גיליון גיליון noun masculine singular absolute unspecified unspecified  	O	null
8 שלם שלם שלם adjective masculine singular absolute unspecified unspecified  	O	null
9 , , , punctuation unspecified unspecified unspecified unspecified unspecified  	O	null
10 ו ו ורק conjunction unspecified unspecified unspecified unspecified unspecified 0 
10 רק רק ורק conjunction unspecified unspecified unspecified unspecified unspecified  	O	null
11 אחרכך אחרכך אחרכך adverb unspecified unspecified unspecified unspecified unspecified  	O	null
12 פורסם פורסם פורסם verb masculine singular unspecified 3 past  	O	null
13 כ כ כספר preposition unspecified unspecified unspecified unspecified unspecified 0 
13 ה ה כספר definiteArticle unspecified unspecified unspecified unspecified unspecified 0 
13 הספר ספר כספר noun masculine singular absolute unspecified unspecified  	O	null
14 . . . punctuation unspecified unspecified unspecified unspecified unspecified  	O	null

0 אשת איש אשתו noun feminine singular absolute unspecified unspecified  
0 ו ו אשתו possessive masculine singular unspecified 3 unspecified 0 	O	null
1 נינה נינה נינה properName unspecified unspecified unspecified unspecified unspecified  	I_PERS	null
2 סיפרה סיפר סיפרה verb feminine singular unspecified 3 past  	O	null
3 ש ש שכשהיה relativizer/subordinatingConjunction unspecified unspecified unspecified unspecified unspecified 0 
3 כש כש שכשהיה temporalSubConj unspecified unspecified unspecified unspecified unspecified 0 
3 היה הוא שכשהיה copula masculine singular unspecified 3 past  	O	null
4 יושב ישב יושב verb masculine singular unspecified any beinoni  	O	null
5 לכתוב כתב לכתוב verb unspecified unspecified unspecified unspecified infinitive  	O	null
6 , , , punctuation unspecified unspecified unspecified unspecified unspecified  	O	null
7 היה הוא היה copula masculine singular unspecified 3 past  	O	null
8 מסתגר הסתגר מסתגר verb masculine singular unspecified any beinoni  	O	null
9 ב ב בחדרו preposition unspecified unspecified unspecified unspecified unspecified 0 
9 חדר חדר בחדרו noun masculine singular absolute unspecified unspecified  
9 ו ו בחדרו possessive masculine singular unspecified 3 unspecified 0 	O	null
10 , , , punctuation unspecified unspecified unspecified unspecified unspecified  	O	null
11 לבוש לבוש לבוש noun masculine singular absolute unspecified unspecified  	O	null
12 ב ב בכתונת preposition unspecified unspecified unspecified unspecified unspecified 0 
12 כתונת כתונת בכתונת noun feminine singular construct unspecified unspecified  	O	null
13 ה ה האסיר definiteArticle unspecified unspecified unspecified unspecified unspecified 0 
13 האסיר אסיר האסיר noun masculine singular absolute unspecified unspecified  	O	null
14 של של שלו shel-preposition unspecified unspecified unspecified unspecified unspecified  
14 ו ו שלו pronomial masculine singular unspecified 3 unspecified 0 	O	null
15 , , , punctuation unspecified unspecified unspecified unspecified unspecified  	O	null
16 ו ו ונמנע conjunction unspecified unspecified unspecified unspecified unspecified 0 
16 נמנע נמנע ונמנע verb masculine singular unspecified any beinoni  	O	null
17 במשך במשך במשך preposition unspecified unspecified unspecified unspecified unspecified  	O	null
18 ימים יום ימים noun masculine plural absolute unspecified unspecified  	O	null
19 רבים רב רבים adjective masculine plural absolute unspecified unspecified  	O	null
20 מ מ מרחצה preposition unspecified unspecified unspecified unspecified unspecified 0 
20 רחצה רחצה מרחצה noun feminine singular absolute unspecified unspecified  	O	null
21 ו ו ומאוכל conjunction unspecified unspecified unspecified unspecified unspecified 0 
21 מ מ ומאוכל preposition unspecified unspecified unspecified unspecified unspecified 0 
21 אוכל אוכל ומאוכל noun masculine singular absolute unspecified unspecified  	O	null
22 . . . punctuation unspecified unspecified unspecified unspecified unspecified  	O	null

0 ב ב באחד preposition unspecified unspecified unspecified unspecified unspecified 0 
0 אחד CARD1 באחד numeral masculine singular absolute unspecified unspecified  	I_LOC	null
1 הטרנסים הטרנסים הטרנסים properName unspecified unspecified unspecified unspecified unspecified  	B_LOC	null
2 , , , punctuation unspecified unspecified unspecified unspecified unspecified  	O	null
3 ב ב במהלך preposition unspecified unspecified unspecified unspecified unspecified 0 
3 מהלך מהלך במהלך noun masculine singular construct unspecified unspecified  	O	null
4 ה ה הטיפול definiteArticle unspecified unspecified unspecified unspecified unspecified 0 
4 הטיפול טיפול הטיפול noun masculine singular absolute unspecified unspecified  	O	null
5 ב ב בסם preposition unspecified unspecified unspecified unspecified unspecified 0 
5 סם סם בסם properName unspecified unspecified unspecified unspecified unspecified  	I_PERS	null
6 , , , punctuation unspecified unspecified unspecified unspecified unspecified  	O	null
7 מצא מצא מצא verb masculine singular unspecified 3 past  	O	null
8 עצמו עצמו עצמו pronoun unspecified unspecified unspecified unspecified unspecified  
8 ו ו עצמו pronomial masculine singular unspecified 3 unspecified 0 	O	null
9 ק' ק' ק' verb masculine singular unspecified 3 past  	O	null
10 צטניק צטניק צטניק noun masculine singular absolute unspecified unspecified  	O	null
11 לבוש לבוש לבוש adjective masculine singular absolute unspecified unspecified  	O	null
12 ב ב במדי preposition unspecified unspecified unspecified unspecified unspecified 0 
12 מדי מדי במדי quantifier unspecified unspecified construct unspecified unspecified  	O	null
13 אס אס אס properName unspecified unspecified unspecified unspecified unspecified  	I_LOC	null
14 - - - punctuation unspecified unspecified unspecified unspecified unspecified  	O	null
15 אס אס אס properName unspecified unspecified unspecified unspecified unspecified  	I_ORG	null
16 ו ו וחבוש conjunction unspecified unspecified unspecified unspecified unspecified 0 
16 חבוש חבוש וחבוש noun masculine singular absolute unspecified unspecified  	O	null
17 ב ב בכובע preposition unspecified unspecified unspecified unspecified unspecified 0 
17 כובע כובע בכובע noun masculine singular absolute unspecified unspecified  	O	null
18 עם עם עם preposition unspecified unspecified unspecified unspecified unspecified  	O	null
19 סמל סמל סמל noun masculine singular construct unspecified unspecified  	O	null
20 ה ה הגולגולת definiteArticle unspecified unspecified unspecified unspecified unspecified 0 
20 הגולגולת גולגולת הגולגולת noun feminine singular absolute unspecified unspecified  	O	null
21 . . . punctuation unspecified unspecified unspecified unspecified unspecified  	O	null

0 חיזיון חיזיון חיזיון noun masculine singular absolute unspecified unspecified  	O	null
1 זה זה זה pronoun masculine singular unspecified 3 unspecified  	O	null
2 זיעזע זיעזע זיעזע verb masculine singular unspecified 3 past  	O	null
3 את את אותו at-preposition unspecified unspecified unspecified unspecified unspecified  
3 ו ו אותו pronomial masculine singular unspecified 3 unspecified 0 	O	null
4 ו ו ושינה conjunction unspecified unspecified unspecified unspecified unspecified 0 
4 שינה שינה ושינה verb masculine singular unspecified 3 past  	O	null
5 את את את at-preposition unspecified unspecified unspecified unspecified unspecified  	O	null
6 עמדת עמדה עמדתו noun feminine singular absolute unspecified unspecified  
6 ו ו עמדתו possessive masculine singular unspecified 3 unspecified 0 	O	null
7 כלפי כלפי כלפי preposition unspecified unspecified unspecified unspecified unspecified  	O	null
8 אושוויץ אושוויץ אושוויץ properName unspecified unspecified unspecified unspecified unspecified  	I_LOC	null
9 : : : punctuation unspecified unspecified unspecified unspecified unspecified  	O	null
10 ה ה הקורבן definiteArticle unspecified unspecified unspecified unspecified unspecified 0 
10 הקורבן קורבן הקורבן noun masculine singular absolute unspecified unspecified  	O	null
11 ו ו והתליין conjunction unspecified unspecified unspecified unspecified unspecified 0 
11 ה ה והתליין definiteArticle unspecified unspecified unspecified unspecified unspecified 0 
11 התליין התליין והתליין noun masculine singular absolute unspecified unspecified  	O	null
12 , , , punctuation unspecified unspecified unspecified unspecified unspecified  	O	null
13 שניים שניים שניהם pronoun unspecified unspecified unspecified unspecified unspecified  
13 הם הם שניהם pronomial masculine plural unspecified 3 unspecified 0 	O	null
14 בני בן בני noun masculine plural construct unspecified unspecified  	O	null
15 אדם אדם אדם noun masculine singular absolute unspecified unspecified  	O	null
16 , , , punctuation unspecified unspecified unspecified unspecified unspecified  	O	null
17 ו ו ובקלות conjunction unspecified unspecified unspecified unspecified unspecified 0 
17 ב ב ובקלות preposition unspecified unspecified unspecified unspecified unspecified 0 
17 ה ה ובקלות definiteArticle unspecified unspecified unspecified unspecified unspecified 0 
17 הקלות קלות ובקלות noun feminine singular absolute unspecified unspecified  	O	null
18 עשויים עשוי עשויים modal masculine plural unspecified any unspecified  	O	null
19 להתחלף התחלף להתחלף verb unspecified unspecified unspecified unspecified infinitive  	O	null
20 ב ב בתפקידיהם preposition unspecified unspecified unspecified unspecified unspecified 0 
20 תפקידי תפקיד בתפקידיהם noun masculine plural absolute unspecified unspecified  
20 הם הם בתפקידיהם possessive masculine plural unspecified 3 unspecified 0 	O	null
21 . . . punctuation unspecified unspecified unspecified unspecified unspecified  	O	null

0 אושוויץ אושוויץ אושוויץ properName unspecified unspecified unspecified unspecified unspecified  	I_LOC	null
1 אינו הוא אינו copula masculine singular unspecified 3 beinoni  	O	null
2 עוד עוד עוד adverb unspecified unspecified unspecified unspecified unspecified  	O	null
3 פלנטה פלנטה פלנטה noun feminine singular absolute unspecified unspecified  	O	null
4 אחרת אחר אחרת adjective feminine singular absolute unspecified unspecified  	O	null
5 – – – punctuation unspecified unspecified unspecified unspecified unspecified  	O	null
6 אלא אלא אלא conjunction unspecified unspecified unspecified unspecified unspecified  	O	null
7 רובץ רבץ רובץ verb masculine singular unspecified any beinoni  	O	null
8 ל ל לפתחו preposition unspecified unspecified unspecified unspecified unspecified 0 
8 פתח פתח לפתחו noun masculine singular absolute unspecified unspecified  
8 ו ו לפתחו possessive masculine singular unspecified 3 unspecified 0 	O	null
9 של של של shel-preposition unspecified unspecified unspecified unspecified unspecified  	O	null
10 כל כול כל quantifier unspecified unspecified construct unspecified unspecified  	O	null
11 אדם אדם אדם noun masculine singular absolute unspecified unspecified  	O	null
12 . . . punctuation unspecified unspecified unspecified unspecified unspecified  	O	null

0 " " " punctuation unspecified unspecified unspecified unspecified unspecified  	O	null
1 באשר באשר באשר conjunction unspecified unspecified unspecified unspecified unspecified  	O	null
2 ה ה האדם definiteArticle unspecified unspecified unspecified unspecified unspecified 0 
2 האדם אדם האדם noun masculine singular absolute unspecified unspecified  	O	null
3 – – – punctuation unspecified unspecified unspecified unspecified unspecified  	O	null
4 שם שם שם adverb unspecified unspecified unspecified unspecified unspecified  	O	null
5 אושוויץ אושוויץ אושוויץ properName unspecified unspecified unspecified unspecified unspecified  	I_LOC	null
6 , , , punctuation unspecified unspecified unspecified unspecified unspecified  	O	null
7 כי כי כי conjunction unspecified unspecified unspecified unspecified unspecified  	O	null
8 לא לא לא negation unspecified unspecified unspecified unspecified unspecified  	O	null
9 ה ה השטן definiteArticle unspecified unspecified unspecified unspecified unspecified 0 
9 השטן שטן השטן noun masculine singular absolute unspecified unspecified  	O	null
10 יצר יצר יצר verb masculine singular unspecified 3 past  	O	null
11 את את את at-preposition unspecified unspecified unspecified unspecified unspecified  	O	null
12 אושוויץ אושוויץ אושוויץ properName unspecified unspecified unspecified unspecified unspecified  	I_LOC	null
13 אלא אלא אלא conjunction unspecified unspecified unspecified unspecified unspecified  	O	null
14 אני הוא אני pronoun masculine-and-feminine singular unspecified 1 unspecified  	O	null
15 ו ו ואתה conjunction unspecified unspecified unspecified unspecified unspecified 0 
15 את את ואתה at-preposition unspecified unspecified unspecified unspecified unspecified  
15 ה ה ואתה pronomial feminine singular unspecified 3 unspecified 0 	O	null
16 [ [ [ punctuation unspecified unspecified unspecified unspecified unspecified  	O	null
17 ... ... ... punctuation unspecified unspecified unspecified unspecified unspecified  	O	null
18 ] ] ] punctuation unspecified unspecified unspecified unspecified unspecified  	O	null
19 " " " punctuation unspecified unspecified unspecified unspecified unspecified  	O	null
20 ( ( ( punctuation unspecified unspecified unspecified unspecified unspecified  	O	null
21 ה ה הצופן definiteArticle unspecified unspecified unspecified unspecified unspecified 0 
21 הצופן צופן הצופן noun masculine singular absolute unspecified unspecified  	O	null
22 , , , punctuation unspecified unspecified unspecified unspecified unspecified  	O	null
23 ) ) ) punctuation unspecified unspecified unspecified unspecified unspecified  	O	null
24 . . . punctuation unspecified unspecified unspecified unspecified unspecified  	O	null
25 ###NUMBER### ###NUMBER### ###NUMBER### numeral unspecified unspecified unspecified unspecified unspecified  	O	null
26 ב ב בריאיון preposition unspecified unspecified unspecified unspecified unspecified 0 
26 ריאיון ראיון בריאיון noun masculine singular absolute unspecified unspecified  	O	null
27 ל ל לרם preposition unspecified unspecified unspecified unspecified unspecified 0 
27 רם רם לרם properName unspecified unspecified unspecified unspecified unspecified  	I_PERS	null
28 עברון עברון עברון properName unspecified unspecified unspecified unspecified unspecified  	I_PERS	null
29 ב ב בערוץ preposition unspecified unspecified unspecified unspecified unspecified 0 
29 ה ה בערוץ definiteArticle unspecified unspecified unspecified unspecified unspecified 0 
29 הערוץ ערוץ בערוץ noun masculine singular absolute unspecified unspecified  	O	null
30 ה ה הראשון definiteArticle unspecified unspecified unspecified unspecified unspecified 0 
30 הראשון ORD1 הראשון numeral masculine singular absolute unspecified unspecified  	O	null
31 של של של shel-preposition unspecified unspecified unspecified unspecified unspecified  	O	null
32 ה ה הטלוויזיה definiteArticle unspecified unspecified unspecified unspecified unspecified 0 
32 הטלוויזיה טלוויזיה הטלוויזיה noun feminine singular absolute unspecified unspecified  	O	null
33 ה ה הישראלית definiteArticle unspecified unspecified unspecified unspecified unspecified 0 
33 הישראלית ישראלי הישראלית adjective feminine singular absolute unspecified unspecified  	O	null
34 הוא הוא הוא pronoun masculine singular unspecified 3 unspecified  	O	null
35 חזר חזר חזר verb masculine singular unspecified 3 past  	O	null
36 על על על preposition unspecified unspecified unspecified unspecified unspecified  	O	null
37 כך כך כך pronoun unspecified unspecified unspecified unspecified unspecified  	O	null
38 : : : punctuation unspecified unspecified unspecified unspecified unspecified  	O	null
39 " " " punctuation unspecified unspecified unspecified unspecified unspecified  	I_LOC	null
40 אושוויץ אושוויץ אושוויץ properName unspecified unspecified unspecified unspecified unspecified  	I_LOC	null
41 ה ה החזרה definiteArticle unspecified unspecified unspecified unspecified unspecified 0 
41 החזרה חזרה החזרה noun feminine singular absolute unspecified unspecified  	O	null
42 ה ה הגנרלית definiteArticle unspecified unspecified unspecified unspecified unspecified 0 
42 הגנרלית גנרל הגנרלית adjective feminine singular absolute unspecified unspecified  	O	null
43 ל ל לדבר preposition unspecified unspecified unspecified unspecified unspecified 0 
43 דבר דבר לדבר noun masculine singular absolute unspecified unspecified  	O	null
44 ש ש שאנו relativizer/subordinatingConjunction unspecified unspecified unspecified unspecified unspecified 0 
44 אנו הוא שאנו pronoun masculine-and-feminine plural unspecified 1 unspecified  	O	null
45 עומדים עמד עומדים verb masculine plural unspecified any beinoni  	O	null
46 לפני לפני לפניו preposition unspecified unspecified unspecified unspecified unspecified  
46 ו ו לפניו pronomial masculine singular unspecified 3 unspecified 0 	O	null
47 " " " punctuation unspecified unspecified unspecified unspecified unspecified  	O	null
48 . . . punctuation unspecified unspecified unspecified unspecified unspecified  	O	null

0 ה ה האדם definiteArticle unspecified unspecified unspecified unspecified unspecified 0 
0 האדם אדם האדם noun masculine singular absolute unspecified unspecified  	O	null
1 יצר יצר יצר verb masculine singular unspecified 3 past  	O	null
2 את את את at-preposition unspecified unspecified unspecified unspecified unspecified  	O	null
3 אושוויץ אושוויץ אושוויץ properName unspecified unspecified unspecified unspecified unspecified  	I_LOC	null
4 , , , punctuation unspecified unspecified unspecified unspecified unspecified  	O	null
5 ו ו והוא conjunction unspecified unspecified unspecified unspecified unspecified 0 
5 הוא הוא והוא pronoun masculine singular unspecified 3 unspecified  	O	null
6 יהיה הוא יהיה copula masculine singular unspecified 3 future  	O	null
7 גם גם גם conjunction unspecified unspecified unspecified unspecified unspecified  	O	null
8 זה זה זה pronoun masculine singular unspecified 3 unspecified  	O	null
9 ש ש שילחץ relativizer/subordinatingConjunction unspecified unspecified unspecified unspecified unspecified 0 
9 ילחץ לחץ שילחץ verb masculine singular unspecified 3 future  	O	null
10 על על על preposition unspecified unspecified unspecified unspecified unspecified  	O	null
11 ה ה הכפתור definiteArticle unspecified unspecified unspecified unspecified unspecified 0 
11 הכפתור כפתור הכפתור noun masculine singular absolute unspecified unspecified  	O	null
12 ש ש שיהפוך relativizer/subordinatingConjunction unspecified unspecified unspecified unspecified unspecified 0 
12 יהפוך הפך שיהפוך verb masculine singular unspecified 3 future  	O	null
13 את את את at-preposition unspecified unspecified unspecified unspecified unspecified  	O	null
14 ה ה העולם definiteArticle unspecified unspecified unspecified unspecified unspecified 0 
14 העולם עולם העולם noun masculine singular absolute unspecified unspecified  	O	null
15 ל ל לתוהו preposition unspecified unspecified unspecified unspecified unspecified 0 
15 ה ה לתוהו definiteArticle unspecified unspecified unspecified unspecified unspecified 0 
15 התוהו תוהו לתוהו noun masculine singular absolute unspecified unspecified  	O	null
16 . . . punctuation unspecified unspecified unspecified unspecified unspecified  	O	null

0 לק לק לק preposition unspecified unspecified unspecified unspecified unspecified  	O	null
1 ' ' ' punctuation unspecified unspecified unspecified unspecified unspecified  	O	null
2 צטניק צטניק צטניק noun masculine singular construct unspecified unspecified  	O	null
3 זכות זכות זכות noun feminine singular construct unspecified unspecified  	O	null
4 ראשונים ראשונים ראשונים noun masculine plural absolute unspecified unspecified  	O	null
5 ל ל לפריצת preposition unspecified unspecified unspecified unspecified unspecified 0 
5 פריצת פריצה לפריצת noun feminine singular construct unspecified unspecified  	O	null
6 חומת חומה חומת noun feminine singular construct unspecified unspecified  	O	null
7 ה ה ההדחקה definiteArticle unspecified unspecified unspecified unspecified unspecified 0 
7 ההדחקה הדחקה ההדחקה noun feminine singular absolute unspecified unspecified  	O	null
8 של של של shel-preposition unspecified unspecified unspecified unspecified unspecified  	O	null
9 זיכרון זיכרון זיכרון noun masculine singular construct unspecified unspecified  	O	null
10 ה ה השואה definiteArticle unspecified unspecified unspecified unspecified unspecified 0 
10 השואה שואה השואה noun feminine singular absolute unspecified unspecified  	O	null
11 על על על preposition unspecified unspecified unspecified unspecified unspecified  	O	null
12 ידי יד ידי noun feminine plural construct unspecified unspecified  	O	null
13 ה ה הציבור definiteArticle unspecified unspecified unspecified unspecified unspecified 0 
13 הציבור ציבור הציבור noun masculine singular absolute unspecified unspecified  	O	null
14 ה ה הישראלי definiteArticle unspecified unspecified unspecified unspecified unspecified 0 
14 הישראלי ישראלי הישראלי adjective masculine singular absolute unspecified unspecified  	O	null
15 , , , punctuation unspecified unspecified unspecified unspecified unspecified  	O	null
16 ו ו ולהעלאתו conjunction unspecified unspecified unspecified unspecified unspecified 0 
16 ל ל ולהעלאתו preposition unspecified unspecified unspecified unspecified unspecified 0 
16 העלאת העלאה ולהעלאתו noun feminine singular absolute unspecified unspecified  
16 ו ו ולהעלאתו possessive masculine singular unspecified 3 unspecified 0 	O	null
17 ל ל לתודעה preposition unspecified unspecified unspecified unspecified unspecified 0 
17 ה ה לתודעה definiteArticle unspecified unspecified unspecified unspecified unspecified 0 
17 התודעה תודעה לתודעה noun feminine singular absolute unspecified unspecified  	O	null
18 ה ה הקולקטיבית definiteArticle unspecified unspecified unspecified unspecified unspecified 0 
18 הקולקטיבית קולקטיבי הקולקטיבית adjective feminine singular absolute unspecified unspecified  	O	null
19 . . . punctuation unspecified unspecified unspecified unspecified unspecified  	O	null

0 ב ב בשנות preposition unspecified unspecified unspecified unspecified unspecified 0 
0 שנות שנה בשנות noun feminine plural construct unspecified unspecified  	I_DATE	null
1 ה ה החמישים definiteArticle unspecified unspecified unspecified unspecified unspecified 0 
1 החמישים ORD-CARD50 החמישים numeral masculine plural absolute unspecified unspecified  	I_DATE	null
2 ו ו והשישים conjunction unspecified unspecified unspecified unspecified unspecified 0 
2 ה ה והשישים definiteArticle unspecified unspecified unspecified unspecified unspecified 0 
2 השישים ORD-CARD60 והשישים numeral masculine-and-feminine plural absolute unspecified unspecified  	O	null
3 היתה הוא היתה copula feminine singular unspecified 3 past  	O	null
4 ל ל לספריו preposition unspecified unspecified unspecified unspecified unspecified 0 
4 ספרי ספר לספריו noun masculine plural absolute unspecified unspecified  
4 ו ו לספריו possessive masculine singular unspecified 3 unspecified 0 	O	null
5 השפעה השפעה השפעה noun feminine singular absolute unspecified unspecified  	O	null
6 רבה רב רבה adjective feminine singular absolute unspecified unspecified  	O	null
7 , , , punctuation unspecified unspecified unspecified unspecified unspecified  	O	null
8 ש ש שהלכה relativizer/subordinatingConjunction unspecified unspecified unspecified unspecified unspecified 0 
8 הלכה הלך שהלכה verb feminine singular unspecified 3 past  	O	null
9 ו ו והתמעטה conjunction unspecified unspecified unspecified unspecified unspecified 0 
9 התמעטה התמעט והתמעטה verb feminine singular unspecified 3 past  	O	null
10 . . . punctuation unspecified unspecified unspecified unspecified unspecified  	O	null

0 ב ב בסוף preposition unspecified unspecified unspecified unspecified unspecified 0 
0 סוף סוף בסוף noun masculine singular construct unspecified unspecified  	O	null
1 שנות שנה שנות noun feminine plural construct unspecified unspecified  	I_DATE	null
2 ה ה השמונים definiteArticle unspecified unspecified unspecified unspecified unspecified 0 
2 השמונים ORD-CARD80 השמונים numeral masculine-and-feminine plural absolute unspecified unspecified  	I_DATE	null
3 הוכנסו הוכנס הוכנסו verb masculine-and-feminine plural unspecified 3 past  	O	null
4 ספרי ספר ספריו noun masculine plural absolute unspecified unspecified  
4 ו ו ספריו possessive masculine singular unspecified 3 unspecified 0 	O	null
5 ל ל לתוכנית preposition unspecified unspecified unspecified unspecified unspecified 0 
5 תוכנית תוכנייה לתוכנית noun feminine singular construct unspecified unspecified  	O	null
6 ה ה הלימודים definiteArticle unspecified unspecified unspecified unspecified unspecified 0 
6 הלימודים לימוד הלימודים noun masculine plural absolute unspecified unspecified  	O	null
7 על על על preposition unspecified unspecified unspecified unspecified unspecified  	O	null
8 ידי יד ידי noun feminine plural construct unspecified unspecified  	O	null
9 משרד משרד משרד noun masculine singular construct unspecified unspecified  	I_ORG	null
10 ה ה החינוך definiteArticle unspecified unspecified unspecified unspecified unspecified 0 
10 החינוך חינוך החינוך noun masculine singular absolute unspecified unspecified  	I_ORG	null
11 ו ו ואף conjunction unspecified unspecified unspecified unspecified unspecified 0 
11 אף אף ואף conjunction unspecified unspecified unspecified unspecified unspecified  	O	null
12 חולקו חולק חולקו verb masculine-and-feminine plural unspecified 3 past  	O	null
13 בחינם בחינם בחינם adverb unspecified unspecified unspecified unspecified unspecified  	O	null
14 ב ב בבתי preposition unspecified unspecified unspecified unspecified unspecified 0 
14 בתי בית בבתי noun masculine plural construct unspecified unspecified  	O	null
15 ה ה הספר definiteArticle unspecified unspecified unspecified unspecified unspecified 0 
15 הספר ספר הספר noun masculine singular absolute unspecified unspecified  	O	null
16 , , , punctuation unspecified unspecified unspecified unspecified unspecified  	O	null
17 אך אך אך conjunction unspecified unspecified unspecified unspecified unspecified  	O	null
18 פעולה פעולה פעולה noun feminine singular absolute unspecified unspecified  	O	null
19 זו זו זו pronoun feminine singular unspecified 3 unspecified  	O	null
20 לא לא לא negation unspecified unspecified unspecified unspecified unspecified  	O	null
21 הצליחה הצליח הצליחה verb feminine singular unspecified 3 past  	O	null
22 להחזיר החזיר להחזיר verb unspecified unspecified unspecified unspecified infinitive  	O	null
23 לו לו לו conjunction unspecified unspecified unspecified unspecified unspecified  	O	null
24 את את את at-preposition unspecified unspecified unspecified unspecified unspecified  	O	null
25 מעמד מעמד מעמדו noun masculine singular absolute unspecified unspecified  
25 ו ו מעמדו possessive masculine singular unspecified 3 unspecified 0 	O	null
26 כ כ כסופר preposition unspecified unspecified unspecified unspecified unspecified 0 
26 סופר סופר כסופר noun masculine singular construct unspecified unspecified  	O	null
27 שואה שואה שואה noun feminine singular absolute unspecified unspecified  	O	null
28 מרכזי מרכזי מרכזי adjective masculine singular absolute unspecified unspecified  	O	null
29 . . . punctuation unspecified unspecified unspecified unspecified unspecified  	O	null

0 כוח כוח כוחם noun masculine singular absolute unspecified unspecified  
0 ם ם כוחם possessive masculine plural unspecified 3 unspecified 0 	O	null
1 של של של shel-preposition unspecified unspecified unspecified unspecified unspecified  	O	null
2 ספרי ספר ספרי noun masculine plural construct unspecified unspecified  	O	null
3 ק' ק' ק' properName unspecified unspecified unspecified unspecified unspecified  	O	null
4 צטניק צטניק צטניק noun masculine singular absolute unspecified unspecified  	O	null
5 הוא הוא הוא pronoun masculine singular unspecified 3 unspecified  	O	null
6 ב ב בתיאורים preposition unspecified unspecified unspecified unspecified unspecified 0 
6 ה ה בתיאורים definiteArticle unspecified unspecified unspecified unspecified unspecified 0 
6 התיאורים תיאור בתיאורים noun masculine plural absolute unspecified unspecified  	O	null
7 ה ה העזים definiteArticle unspecified unspecified unspecified unspecified unspecified 0 
7 העזים עז העזים adjective masculine plural absolute unspecified unspecified  	O	null
8 , , , punctuation unspecified unspecified unspecified unspecified unspecified  	O	null
9 ש ש שנוגעים relativizer/subordinatingConjunction unspecified unspecified unspecified unspecified unspecified 0 
9 נוגעים נגע שנוגעים verb masculine plural unspecified any beinoni  	O	null
10 ב ב בלב preposition unspecified unspecified unspecified unspecified unspecified 0 
10 לב לב בלב noun masculine singular construct unspecified unspecified  	O	null
11 ה ה הטראומה definiteArticle unspecified unspecified unspecified unspecified unspecified 0 
11 הטראומה טראומה הטראומה noun feminine singular absolute unspecified unspecified  	O	null
12 ב ב בגיהינום preposition unspecified unspecified unspecified unspecified unspecified 0 
12 ה ה בגיהינום definiteArticle unspecified unspecified unspecified unspecified unspecified 0 
12 הגיהינום גיהינום בגיהינום noun masculine-and-feminine singular absolute unspecified unspecified  	O	null
13 ש ש ששמו relativizer/subordinatingConjunction unspecified unspecified unspecified unspecified unspecified 0 
13 שם שם ששמו noun masculine singular absolute unspecified unspecified  
13 ו ו ששמו possessive masculine singular unspecified 3 unspecified 0 	O	null
14 " " " punctuation unspecified unspecified unspecified unspecified unspecified  	O	null
15 אושוויץ אושוויץ אושוויץ properName unspecified unspecified unspecified unspecified unspecified  	I_ORG	null
16 " " " punctuation unspecified unspecified unspecified unspecified unspecified  	O	null
17 , , , punctuation unspecified unspecified unspecified unspecified unspecified  	O	null
18 ש ש שכדברי relativizer/subordinatingConjunction unspecified unspecified unspecified unspecified unspecified 0 
18 כ כ שכדברי preposition unspecified unspecified unspecified unspecified unspecified 0 
18 דברי דבר שכדברי noun masculine plural construct unspecified unspecified  	O	null
19 דן דן דן properName unspecified unspecified unspecified unspecified unspecified  	I_ORG	null
20 מירון מירון מירון properName unspecified unspecified unspecified unspecified unspecified  	I_ORG	null
21 ( ( ( punctuation unspecified unspecified unspecified unspecified unspecified  	O	null
22 שם שם שם adverb unspecified unspecified unspecified unspecified unspecified  	O	null
23 ) ) ) punctuation unspecified unspecified unspecified unspecified unspecified  	O	null
24 " " " punctuation unspecified unspecified unspecified unspecified unspecified  	O	null
25 הלמו הלם הלמו verb masculine-and-feminine plural unspecified 3 past  	O	null
26 כ כ כקורנס preposition unspecified unspecified unspecified unspecified unspecified 0 
26 ה ה כקורנס definiteArticle unspecified unspecified unspecified unspecified unspecified 0 
26 הקורנס קורנס כקורנס noun masculine singular absolute unspecified unspecified  	O	null
27 על על על preposition unspecified unspecified unspecified unspecified unspecified  	O	null
28 ראשי ראש ראשי noun masculine plural construct unspecified unspecified  	O	null
29 ה ה הקוראים definiteArticle unspecified unspecified unspecified unspecified unspecified 0 
29 הקוראים קורא הקוראים noun masculine plural absolute unspecified unspecified  	O	null
30 " " " punctuation unspecified unspecified unspecified unspecified unspecified  	O	null
31 . . . punctuation unspecified unspecified unspecified unspecified unspecified  	O	null

0 למרות למרות למרות conjunction unspecified unspecified unspecified unspecified unspecified  	O	null
1 ה ה הפופולריות definiteArticle unspecified unspecified unspecified unspecified unspecified 0 
1 הפופולריות פופולריות הפופולריות noun feminine singular absolute unspecified unspecified  	O	null
2 של של שלה shel-preposition unspecified unspecified unspecified unspecified unspecified  
2 ה ה שלה pronomial feminine singular unspecified 3 unspecified 0 	O	null
3 זכו זכה זכו verb masculine-and-feminine plural unspecified 3 past  	O	null
4 ספרי ספר ספריו noun masculine plural absolute unspecified unspecified  
4 ו ו ספריו possessive masculine singular unspecified 3 unspecified 0 	O	null
5 בקרב בקרב בקרב preposition unspecified unspecified unspecified unspecified unspecified  	O	null
6 ה ה הציבור definiteArticle unspecified unspecified unspecified unspecified unspecified 0 
6 הציבור ציבור הציבור noun masculine singular absolute unspecified unspecified  	O	null
7 ה ה הרחב definiteArticle unspecified unspecified unspecified unspecified unspecified 0 
7 הרחב רחב הרחב adjective masculine singular absolute unspecified unspecified  	O	null
8 , , , punctuation unspecified unspecified unspecified unspecified unspecified  	O	null
9 דרך דרך דרך noun feminine singular construct unspecified unspecified  	O	null
10 ה ה הייצוג definiteArticle unspecified unspecified unspecified unspecified unspecified 0 
10 הייצוג ייצוג הייצוג noun masculine singular absolute unspecified unspecified  	O	null
11 של של שלו shel-preposition unspecified unspecified unspecified unspecified unspecified  
11 ו ו שלו pronomial masculine singular unspecified 3 unspecified 0 	O	null
12 הותקפה הותקף הותקפה verb feminine singular unspecified 3 past  	O	null
13 על על על preposition unspecified unspecified unspecified unspecified unspecified  	O	null
14 ידי יד ידי noun feminine plural construct unspecified unspecified  	O	null
15 ה ה המבקרים definiteArticle unspecified unspecified unspecified unspecified unspecified 0 
15 המבקרים מבקר המבקרים noun masculine plural absolute unspecified unspecified  	O	null
16 . . . punctuation unspecified unspecified unspecified unspecified unspecified  	O	null

0 היא הוא היא pronoun feminine singular unspecified 3 unspecified  	O	null
1 תוארה תואר תוארה verb feminine singular unspecified 3 past  	O	null
2 כ כ כפורנוגרפיה preposition unspecified unspecified unspecified unspecified unspecified 0 
2 פורנוגרפיה פורנוגרפיה כפורנוגרפיה noun feminine singular absolute unspecified unspecified  	O	null
3 ו ו וכקיטש conjunction unspecified unspecified unspecified unspecified unspecified 0 
3 כ כ וכקיטש preposition unspecified unspecified unspecified unspecified unspecified 0 
3 ה ה וכקיטש definiteArticle unspecified unspecified unspecified unspecified unspecified 0 
3 הקיטש קיטש וכקיטש noun masculine singular absolute unspecified unspecified  	O	null
4 , , , punctuation unspecified unspecified unspecified unspecified unspecified  	O	null
5 ה ה החסרים definiteArticle unspecified unspecified unspecified unspecified unspecified 0 
5 החסרים חסר החסרים adjective masculine plural absolute unspecified unspecified  	O	null
6 אמצעי אמצע אמצעי noun masculine plural construct unspecified unspecified  	O	null
7 איפוק איפוק איפוק noun masculine singular absolute unspecified unspecified  	O	null
8 ו ו ועידון conjunction unspecified unspecified unspecified unspecified unspecified 0 
8 עידון עידון ועידון noun masculine singular absolute unspecified unspecified  	O	null
9 , , , punctuation unspecified unspecified unspecified unspecified unspecified  	O	null
10 ו ו ואף conjunction unspecified unspecified unspecified unspecified unspecified 0 
10 אף אף ואף conjunction unspecified unspecified unspecified unspecified unspecified  	O	null
11 הושוותה הושווה הושוותה verb feminine singular unspecified 3 past  	O	null
12 על על על preposition unspecified unspecified unspecified unspecified unspecified  	O	null
13 ידי יד ידי noun feminine plural construct unspecified unspecified  	O	null
14 ב ב ברטוב preposition unspecified unspecified unspecified unspecified unspecified 0 
14 רטוב רטוב ברטוב adjective masculine singular absolute unspecified unspecified  	O	null
15 ( ( ( punctuation unspecified unspecified unspecified unspecified unspecified  	O	null
16 ###NUMBER### ###NUMBER### ###NUMBER### numeral unspecified unspecified unspecified unspecified unspecified  	I_DATE	null
17 ) ) ) punctuation unspecified unspecified unspecified unspecified unspecified  	O	null
18 ל ל לספרות preposition unspecified unspecified unspecified unspecified unspecified 0 
18 ה ה לספרות definiteArticle unspecified unspecified unspecified unspecified unspecified 0 
18 הספרות ספרות לספרות noun feminine singular absolute unspecified unspecified  	O	null
19 ה ה הסטאלגים definiteArticle unspecified unspecified unspecified unspecified unspecified 0 
19 הסטאלגים הסטאלגים הסטאלגים adjective feminine singular absolute unspecified unspecified  	O	null
20 ש ש שנפוצה relativizer/subordinatingConjunction unspecified unspecified unspecified unspecified unspecified 0 
20 נפוצה נפוץ שנפוצה verb feminine singular unspecified 3 past  	O	null
21 ב ב בארץ preposition unspecified unspecified unspecified unspecified unspecified 0 
21 ה ה בארץ definiteArticle unspecified unspecified unspecified unspecified unspecified 0 
21 הארץ ארץ בארץ noun feminine singular absolute unspecified unspecified  	O	null
22 ב ב בשנות preposition unspecified unspecified unspecified unspecified unspecified 0 
22 שנות שנה בשנות noun feminine plural construct unspecified unspecified  	I_DATE	null
23 ה ה החמישים definiteArticle unspecified unspecified unspecified unspecified unspecified 0 
23 החמישים ORD-CARD50 החמישים numeral masculine plural absolute unspecified unspecified  	I_DATE	null
24 . . . punctuation unspecified unspecified unspecified unspecified unspecified  	O	null

0 עם עם עם preposition unspecified unspecified unspecified unspecified unspecified  	O	null
1 זאת זאת זאת pronoun feminine singular unspecified 3 unspecified  	O	null
2 , , , punctuation unspecified unspecified unspecified unspecified unspecified  	O	null
3 גם גם גם conjunction unspecified unspecified unspecified unspecified unspecified  	O	null
4 מבקרי מבקר מבקריו noun masculine plural absolute unspecified unspecified  
4 ו ו מבקריו possessive masculine singular unspecified 3 unspecified 0 	O	null
5 מסכימים הסכים מסכימים verb masculine plural unspecified any beinoni  	O	null
6 ש ש שאולי relativizer/subordinatingConjunction unspecified unspecified unspecified unspecified unspecified 0 
6 אולי אולי שאולי adverb unspecified unspecified unspecified unspecified unspecified  	O	null
7 רק רק רק conjunction unspecified unspecified unspecified unspecified unspecified  	O	null
8 כך כך כך adverb unspecified unspecified unspecified unspecified unspecified  	O	null
9 יכולה יכול יכולה modal feminine singular unspecified any beinoni  	O	null
10 היתה הוא היתה copula feminine singular unspecified 3 past  	O	null
11 ה ה הזוועה definiteArticle unspecified unspecified unspecified unspecified unspecified 0 
11 הזוועה זוועה הזוועה noun feminine singular absolute unspecified unspecified  	O	null
12 לחדור חדר לחדור verb unspecified unspecified unspecified unspecified infinitive  	O	null
13 ל ל לתודעת preposition unspecified unspecified unspecified unspecified unspecified 0 
13 תודעת תודעה לתודעת noun feminine singular construct unspecified unspecified  	O	null
14 ה ה הציבור definiteArticle unspecified unspecified unspecified unspecified unspecified 0 
14 הציבור ציבור הציבור noun masculine singular absolute unspecified unspecified  	O	null
15 ה ה הישראלי definiteArticle unspecified unspecified unspecified unspecified unspecified 0 
15 הישראלי ישראלי הישראלי adjective masculine singular absolute unspecified unspecified  	O	null
16 , , , punctuation unspecified unspecified unspecified unspecified unspecified  	O	null
17 ש ש שהיה relativizer/subordinatingConjunction unspecified unspecified unspecified unspecified unspecified 0 
17 היה הוא שהיה copula masculine singular unspecified 3 past  	O	null
18 עסוק עסוק עסוק adjective masculine singular absolute unspecified unspecified  	O	null
19 ב ב באותה preposition unspecified unspecified unspecified unspecified unspecified 0 
19 אותו אותו באותה quantifier unspecified unspecified unspecified unspecified unspecified  
19 ה ה באותה pronomial feminine singular unspecified 3 unspecified 0 	O	null
20 עת עת עת noun feminine singular absolute unspecified unspecified  	O	null
21 ב ב בהקמת preposition unspecified unspecified unspecified unspecified unspecified 0 
21 הקמת הקמה בהקמת noun feminine singular construct unspecified unspecified  	O	null
22 ה ה המדינה definiteArticle unspecified unspecified unspecified unspecified unspecified 0 
22 המדינה מדינה המדינה noun feminine singular absolute unspecified unspecified  	O	null
23 ו ו ובביסוסה conjunction unspecified unspecified unspecified unspecified unspecified 0 
23 ב ב ובביסוסה preposition unspecified unspecified unspecified unspecified unspecified 0 
23 ביסוס ביסוס ובביסוסה noun masculine singular absolute unspecified unspecified  
23 ה ה ובביסוסה possessive feminine singular unspecified 3 unspecified 0 	O	null
24 . . . punctuation unspecified unspecified unspecified unspecified unspecified  	O	null

0 References References References foreign unspecified unspecified unspecified unspecified unspecified  	O	null
1 : : : punctuation unspecified unspecified unspecified unspecified unspecified  	O	null
2 ב ב ברטוב preposition unspecified unspecified unspecified unspecified unspecified 0 
2 ה ה ברטוב definiteArticle unspecified unspecified unspecified unspecified unspecified 0 
2 הרטוב רטוב ברטוב adjective masculine singular absolute unspecified unspecified  	O	null
3 , , , punctuation unspecified unspecified unspecified unspecified unspecified  	O	null
4 עומר עומר עומר properName unspecified unspecified unspecified unspecified unspecified  	I_LOC	null
5 . . . punctuation unspecified unspecified unspecified unspecified unspecified  	O	null

0 " " " punctuation unspecified unspecified unspecified unspecified unspecified  	O	null
1 קיטש קיטש קיטש noun masculine singular absolute unspecified unspecified  	O	null
2 ו ו וסאדיזם conjunction unspecified unspecified unspecified unspecified unspecified 0 
2 סאדיזם סדיזם וסאדיזם noun masculine singular absolute unspecified unspecified  	O	null
3 ב ב בפלנטה preposition unspecified unspecified unspecified unspecified unspecified 0 
3 פלנטה פלנטה בפלנטה noun feminine singular absolute unspecified unspecified  	O	null
4 של של של shel-preposition unspecified unspecified unspecified unspecified unspecified  	O	null
5 ק ק ק properName unspecified unspecified unspecified unspecified unspecified  	I_PERS	null
6 . . . punctuation unspecified unspecified unspecified unspecified unspecified  	O	null

0 צטניק צטניק צטניק noun masculine singular absolute unspecified unspecified  	O	null
1 : : : punctuation unspecified unspecified unspecified unspecified unspecified  	O	null
2 נוער נוער נוער noun masculine singular absolute unspecified unspecified  	O	null
3 ישראלי ישראלי ישראלי adjective masculine singular absolute unspecified unspecified  	O	null
4 מדמיין דימיין מדמיין verb masculine singular unspecified any beinoni  	O	null
5 את את את at-preposition unspecified unspecified unspecified unspecified unspecified  	O	null
6 ה ה השואה definiteArticle unspecified unspecified unspecified unspecified unspecified 0 
6 השואה שואה השואה noun feminine singular absolute unspecified unspecified  	O	null
7 " " " punctuation unspecified unspecified unspecified unspecified unspecified  	O	null
8 . . . punctuation unspecified unspecified unspecified unspecified unspecified  	O	null

0 אלפיים ORD-CARD2000 אלפיים numeral masculine-and-feminine dual absolute unspecified unspecified  	O	null
1 ###NUMBER### ###NUMBER### ###NUMBER### numeral unspecified unspecified unspecified unspecified unspecified  	O	null
2 . . . punctuation unspecified unspecified unspecified unspecified unspecified  	O	null

0 ###NUMBER### ###NUMBER### ###NUMBER### numeral unspecified unspecified unspecified unspecified unspecified  	I_DATE	null
1 . . . punctuation unspecified unspecified unspecified unspecified unspecified  	O	null

0 - - - punctuation unspecified unspecified unspecified unspecified unspecified  	O	null
1 ###NUMBER### ###NUMBER### ###NUMBER### numeral unspecified unspecified unspecified unspecified unspecified  	O	null
2 ; ; ; punctuation unspecified unspecified unspecified unspecified unspecified  	O	null
3 ###NUMBER### ###NUMBER### ###NUMBER### numeral unspecified unspecified unspecified unspecified unspecified  	O	null
4 דודאי דודא דודאי noun masculine plural construct unspecified unspecified  	O	null
5 , , , punctuation unspecified unspecified unspecified unspecified unspecified  	O	null
6 רינה רינה רינה properName unspecified unspecified unspecified unspecified unspecified  	I_PERS	null
7 . . . punctuation unspecified unspecified unspecified unspecified unspecified  	O	null

0 " " " punctuation unspecified unspecified unspecified unspecified unspecified  	O	null
1 ' ' ' punctuation unspecified unspecified unspecified unspecified unspecified  	O	null
2 קיטש קיטש קיטש noun masculine singular absolute unspecified unspecified  	O	null
3 ו ו וטראומה conjunction unspecified unspecified unspecified unspecified unspecified 0 
3 טראומה טראומה וטראומה noun feminine singular absolute unspecified unspecified  	O	null
4 ' ' ' punctuation unspecified unspecified unspecified unspecified unspecified  	O	null
5 – – – punctuation unspecified unspecified unspecified unspecified unspecified  	O	null
6 מקרה מקרה מקרה noun masculine singular absolute unspecified unspecified  	O	null
7 מבחן מבחן מבחן noun masculine singular absolute unspecified unspecified  	O	null
8 : : : punctuation unspecified unspecified unspecified unspecified unspecified  	O	null
9 ' ' ' punctuation unspecified unspecified unspecified unspecified unspecified  	O	null
10 בית בית בית noun masculine singular absolute unspecified unspecified  	O	null
11 ה ה הבובות' definiteArticle unspecified unspecified unspecified unspecified unspecified 0 
11 הבובות' הבובות' הבובות' participle feminine plural absolute any unspecified  	O	null
12 מאת מאת מאת preposition unspecified unspecified unspecified unspecified unspecified  	O	null
13 ק ק ק properName unspecified unspecified unspecified unspecified unspecified  	I_PERS	null
14 . . . punctuation unspecified unspecified unspecified unspecified unspecified  	O	null

0 צטניק צטניק צטניק noun masculine singular absolute unspecified unspecified  	O	null
1 " " " punctuation unspecified unspecified unspecified unspecified unspecified  	O	null
2 . . . punctuation unspecified unspecified unspecified unspecified unspecified  	O	null

0 מכאן מכאן מכאן adverb unspecified unspecified unspecified unspecified unspecified  	O	null
1 ו ו ו conjunction unspecified unspecified unspecified unspecified unspecified  	O	null
2 ' ' ' punctuation unspecified unspecified unspecified unspecified unspecified  	O	null
3 . . . punctuation unspecified unspecified unspecified unspecified unspecified  	O	null
4 ###NUMBER### ###NUMBER### ###NUMBER### numeral unspecified unspecified unspecified unspecified unspecified  	I_DATE	null
5 . . . punctuation unspecified unspecified unspecified unspecified unspecified  	O	null

0 - - - punctuation unspecified unspecified unspecified unspecified unspecified  	O	null
1 ###NUMBER### ###NUMBER### ###NUMBER### numeral unspecified unspecified unspecified unspecified unspecified  	O	null
2 ; ; ; punctuation unspecified unspecified unspecified unspecified unspecified  	O	null
3 ###NUMBER### ###NUMBER### ###NUMBER### numeral unspecified unspecified unspecified unspecified unspecified  	O	null
4 מ מ מירון preposition unspecified unspecified unspecified unspecified unspecified 0 
4 ירון ירון מירון properName unspecified unspecified unspecified unspecified unspecified  	I_PERS	null
5 , , , punctuation unspecified unspecified unspecified unspecified unspecified  	O	null
6 דן דן דן properName unspecified unspecified unspecified unspecified unspecified  	I_PERS	null
7 . . . punctuation unspecified unspecified unspecified unspecified unspecified  	O	null

0 " " " punctuation unspecified unspecified unspecified unspecified unspecified  	O	null
1 בין בין בין preposition unspecified unspecified unspecified unspecified unspecified  	O	null
2 ספר ספר ספר noun masculine singular absolute unspecified unspecified  	O	null
3 ל ל לאפר preposition unspecified unspecified unspecified unspecified unspecified 0 
3 אפר אפר לאפר noun masculine singular absolute unspecified unspecified  	O	null
4 " " " punctuation unspecified unspecified unspecified unspecified unspecified  	O	null
5 . . . punctuation unspecified unspecified unspecified unspecified unspecified  	O	null

0 אלפיים ORD-CARD2000 אלפיים numeral masculine-and-feminine dual absolute unspecified unspecified  	O	null
1 ###NUMBER### ###NUMBER### ###NUMBER### numeral unspecified unspecified unspecified unspecified unspecified  	O	null
2 . . . punctuation unspecified unspecified unspecified unspecified unspecified  	O	null

0 ###NUMBER### ###NUMBER### ###NUMBER### numeral unspecified unspecified unspecified unspecified unspecified  	I_DATE	null
1 . . . punctuation unspecified unspecified unspecified unspecified unspecified  	O	null

0 - - - punctuation unspecified unspecified unspecified unspecified unspecified  	O	null
1 ###NUMBER### ###NUMBER### ###NUMBER### numeral unspecified unspecified unspecified unspecified unspecified  	O	null
2 ; ; ; punctuation unspecified unspecified unspecified unspecified unspecified  	O	null
3 ###NUMBER### ###NUMBER### ###NUMBER### numeral unspecified unspecified unspecified unspecified unspecified  	O	null
4 שגב שגב שגב properName unspecified unspecified unspecified unspecified unspecified  	I_PERS	null
5 , , , punctuation unspecified unspecified unspecified unspecified unspecified  	O	null
6 תום תום תום noun masculine singular construct unspecified unspecified  	O	null
7 . . . punctuation unspecified unspecified unspecified unspecified unspecified  	O	null

0 " " " punctuation unspecified unspecified unspecified unspecified unspecified  	I_LOC	null
1 טריף טריף טריפ properName unspecified unspecified unspecified unspecified unspecified  	I_LOC	null
2 של של של shel-preposition unspecified unspecified unspecified unspecified unspecified  	O	null
3 ק ק ק properName unspecified unspecified unspecified unspecified unspecified  	I_PERS	null
4 . . . punctuation unspecified unspecified unspecified unspecified unspecified  	O	null

0 צטניק צטניק צטניק noun masculine singular absolute unspecified unspecified  	O	null
1 " " " punctuation unspecified unspecified unspecified unspecified unspecified  	O	null
2 . . . punctuation unspecified unspecified unspecified unspecified unspecified  	O	null

0 כותרת כותרת כותרת noun feminine singular absolute unspecified unspecified  	O	null
1 ראשית ראשי ראשית adjective feminine singular absolute unspecified unspecified  	O	null
2 . . . punctuation unspecified unspecified unspecified unspecified unspecified  	O	null

0 ###NUMEXP### ###NUMEXP### ###NUMEXP### numberExpression unspecified unspecified unspecified unspecified unspecified  	I_DATE	null
1 ; ; ; punctuation unspecified unspecified unspecified unspecified unspecified  	O	null
2 ש ש שיינטוך relativizer/subordinatingConjunction unspecified unspecified unspecified unspecified unspecified 0 
2 יינטוך יינטוך שיינטוך properName unspecified unspecified unspecified unspecified unspecified  	I_PERS	null
3 , , , punctuation unspecified unspecified unspecified unspecified unspecified  	O	null
4 יחיאל יחיאל יחיאל properName unspecified unspecified unspecified unspecified unspecified  	I_PERS	null
5 . . . punctuation unspecified unspecified unspecified unspecified unspecified  	O	null

0 כ כ כמסיח preposition unspecified unspecified unspecified unspecified unspecified 0 
0 ה ה כמסיח definiteArticle unspecified unspecified unspecified unspecified unspecified 0 
0 המסיח הסיח כמסיח participle masculine singular absolute any unspecified  	O	null
1 לפי לפי לפי preposition unspecified unspecified unspecified unspecified unspecified  	O	null
2 תום תום תומו noun masculine singular absolute unspecified unspecified  
2 ו ו תומו possessive masculine singular unspecified 3 unspecified 0 	O	null
3 : : : punctuation unspecified unspecified unspecified unspecified unspecified  	O	null
4 שיחות שיחה שיחות noun feminine plural absolute unspecified unspecified  	O	null
5 עם עם עם preposition unspecified unspecified unspecified unspecified unspecified  	O	null
6 יחיאל יחיאל יחיאל properName unspecified unspecified unspecified unspecified unspecified  	I_PERS	null
7 דינור דינור דינור properName unspecified unspecified unspecified unspecified unspecified  	I_PERS	null
8 . . . punctuation unspecified unspecified unspecified unspecified unspecified  	O	null

0 ירושלים ירושלים ירושלים properName unspecified unspecified unspecified unspecified unspecified  	I_LOC	null
1 : : : punctuation unspecified unspecified unspecified unspecified unspecified  	O	null
2 בית בית בית noun masculine singular construct unspecified unspecified  	O	null
3 לוחמי לוחם לוחמי noun masculine plural construct unspecified unspecified  	O	null
4 ה ה הגטאות definiteArticle unspecified unspecified unspecified unspecified unspecified 0 
4 הגטאות גטו הגטאות noun masculine plural absolute unspecified unspecified  	O	null
5 ו ו ומכון conjunction unspecified unspecified unspecified unspecified unspecified 0 
5 מכון מיכון ומכון noun masculine singular construct unspecified unspecified  	O	null
6 סדן סדן סדן noun masculine singular absolute unspecified unspecified  	O	null
7 . . . punctuation unspecified unspecified unspecified unspecified unspecified  	O	null

0 ; ; ; punctuation unspecified unspecified unspecified unspecified unspecified  	O	null
1 ###NUMBER### ###NUMBER### ###NUMBER### numeral unspecified unspecified unspecified unspecified unspecified  	I_DATE	null
2 - - - punctuation unspecified unspecified unspecified unspecified unspecified  	O	null
3 - - - punctuation unspecified unspecified unspecified unspecified unspecified  	O	null
4 - - - punctuation unspecified unspecified unspecified unspecified unspecified  	O	null
5 . . . punctuation unspecified unspecified unspecified unspecified unspecified  	O	null
6 ' ' ' punctuation unspecified unspecified unspecified unspecified unspecified  	O	null
7 סלמנדרה סלמנדרה סלמנדרה noun feminine singular absolute unspecified unspecified  	O	null
8 ' ' ' punctuation unspecified unspecified unspecified unspecified unspecified  	O	null
9 : : : punctuation unspecified unspecified unspecified unspecified unspecified  	O	null
10 מיתוס מיתוס מיתוס noun masculine singular absolute unspecified unspecified  	O	null
11 ו ו והיסטוריה conjunction unspecified unspecified unspecified unspecified unspecified 0 
11 היסטוריה היסטוריה והיסטוריה noun feminine singular absolute unspecified unspecified  	O	null
12 ב ב בכתבי preposition unspecified unspecified unspecified unspecified unspecified 0 
12 כתבי כתב בכתבי noun masculine plural construct unspecified unspecified  	O	null
13 ק ק ק properName unspecified unspecified unspecified unspecified unspecified  	I_LOC	null
14 . . . punctuation unspecified unspecified unspecified unspecified unspecified  	O	null

0 צטניק צטניק צטניק noun masculine singular absolute unspecified unspecified  	O	null
1 . . . punctuation unspecified unspecified unspecified unspecified unspecified  	O	null

0 תלאביב תלאביב תלאביב properName unspecified unspecified unspecified unspecified unspecified  	I_PERS	null
1 / / / punctuation unspecified unspecified unspecified unspecified unspecified  	O	null
2 ירושלים ירושלים ירושלים properName unspecified unspecified unspecified unspecified unspecified  	I_LOC	null
3 : : : punctuation unspecified unspecified unspecified unspecified unspecified  	O	null
4 כרמל כרמל כרמל properName unspecified unspecified unspecified unspecified unspecified  	I_LOC	null
5 ו ו והאוניברסיטה conjunction unspecified unspecified unspecified unspecified unspecified 0 
5 ה ה והאוניברסיטה definiteArticle unspecified unspecified unspecified unspecified unspecified 0 
5 האוניברסיטה אוניברסיטה והאוניברסיטה noun feminine singular absolute unspecified unspecified  	B_LOC	null
6 ה ה העברית definiteArticle unspecified unspecified unspecified unspecified unspecified 0 
6 העברית עברי העברית adjective feminine singular absolute unspecified unspecified  	I_ORG	null
7 . . . punctuation unspecified unspecified unspecified unspecified unspecified  	O	null

0 ; ; ; punctuation unspecified unspecified unspecified unspecified unspecified  	I_MONEY	null
1 ###NUMBER### ###NUMBER### ###NUMBER### numeral unspecified unspecified unspecified unspecified unspecified  	I_DATE	null
2 Milner Milner Milner foreign unspecified unspecified unspecified unspecified unspecified  	O	null
3 , , , punctuation unspecified unspecified unspecified unspecified unspecified  	O	null
4 Iris Iris Iris foreign unspecified unspecified unspecified unspecified unspecified  	O	null
5 . . . punctuation unspecified unspecified unspecified unspecified unspecified  	O	null

0 " " " punctuation unspecified unspecified unspecified unspecified unspecified  	O	null
1 The The The foreign unspecified unspecified unspecified unspecified unspecified  	O	null
2 ' ' ' punctuation unspecified unspecified unspecified unspecified unspecified  	O	null
3 Gray Gray Gray foreign unspecified unspecified unspecified unspecified unspecified  	O	null
4 zone zone zone foreign unspecified unspecified unspecified unspecified unspecified  	O	null
5 ' ' ' punctuation unspecified unspecified unspecified unspecified unspecified  	O	null
6 revisited revisited revisited foreign unspecified unspecified unspecified unspecified unspecified  	O	null
7 : : : punctuation unspecified unspecified unspecified unspecified unspecified  	O	null
8 the the the foreign unspecified unspecified unspecified unspecified unspecified  	I_ORG	null
9 concentrationary concentrationary concentrationary foreign unspecified unspecified unspecified unspecified unspecified  	I_ORG	null
10 universe universe universe foreign unspecified unspecified unspecified unspecified unspecified  	I_ORG	null
11 in in in foreign unspecified unspecified unspecified unspecified unspecified  	I_ORG	null
12 Ka Ka Ka foreign unspecified unspecified unspecified unspecified unspecified  	I_ORG	null
13 Tzetnik Tzetnik Tzetnik foreign unspecified unspecified unspecified unspecified unspecified  	I_ORG	null
14 ' ' ' punctuation unspecified unspecified unspecified unspecified unspecified  	O	null
15 s s s foreign unspecified unspecified unspecified unspecified unspecified  	O	null
16 literary literary literary foreign unspecified unspecified unspecified unspecified unspecified  	O	null
17 testimony testimony testimony foreign unspecified unspecified unspecified unspecified unspecified  	O	null
18 " " " punctuation unspecified unspecified unspecified unspecified unspecified  	O	null
19 . . . punctuation unspecified unspecified unspecified unspecified unspecified  	O	null

0 Jewish Jewish Jewish foreign unspecified unspecified unspecified unspecified unspecified  	O	null
1 Social Social Social foreign unspecified unspecified unspecified unspecified unspecified  	O	null
2 Studies Studies Studies foreign unspecified unspecified unspecified unspecified unspecified  	O	null
3 . . . punctuation unspecified unspecified unspecified unspecified unspecified  	O	null

0 Vol Vol Vol foreign unspecified unspecified unspecified unspecified unspecified  	O	null
1 . . . punctuation unspecified unspecified unspecified unspecified unspecified  	O	null

0 ###NUMBER### ###NUMBER### ###NUMBER### numeral unspecified unspecified unspecified unspecified unspecified  	O	null
1 no no no foreign unspecified unspecified unspecified unspecified unspecified  	O	null
2 . . . punctuation unspecified unspecified unspecified unspecified unspecified  	O	null

0 ###NUMBER### ###NUMBER### ###NUMBER### numeral unspecified unspecified unspecified unspecified unspecified  	O	null
1 . . . punctuation unspecified unspecified unspecified unspecified unspecified  	O	null

0 ###NUMBER### ###NUMBER### ###NUMBER### numeral unspecified unspecified unspecified unspecified unspecified  	I_DATE	null
1 . . . punctuation unspecified unspecified unspecified unspecified unspecified  	O	null

0 - - - punctuation unspecified unspecified unspecified unspecified unspecified  	O	null
1 ###NUMBER### ###NUMBER### ###NUMBER### numeral unspecified unspecified unspecified unspecified unspecified  	O	null
2 ; ; ; punctuation unspecified unspecified unspecified unspecified unspecified  	O	null
3 ###NUMBER### ###NUMBER### ###NUMBER### numeral unspecified unspecified unspecified unspecified unspecified  	O	null
4 Popkin Popkin Popkin foreign unspecified unspecified unspecified unspecified unspecified  	O	null
5 . . . punctuation unspecified unspecified unspecified unspecified unspecified  	O	null

0 Jeremy Jeremy Jeremy foreign unspecified unspecified unspecified unspecified unspecified  	O	null
1 D D D foreign unspecified unspecified unspecified unspecified unspecified  	O	null
2 . . . punctuation unspecified unspecified unspecified unspecified unspecified  	O	null

0 " " " punctuation unspecified unspecified unspecified unspecified unspecified  	O	null
1 Ka Ka Ka foreign unspecified unspecified unspecified unspecified unspecified  	O	null
2 - - - punctuation unspecified unspecified unspecified unspecified unspecified  	O	null
3 Tzetnik Tzetnik Tzetnik foreign unspecified unspecified unspecified unspecified unspecified  	O	null
4 ###NUMBER### ###NUMBER### ###NUMBER### numeral unspecified unspecified unspecified unspecified unspecified  	O	null
5 : : : punctuation unspecified unspecified unspecified unspecified unspecified  	O	null
6 The The The foreign unspecified unspecified unspecified unspecified unspecified  	O	null
7 Survivor Survivor Survivor foreign unspecified unspecified unspecified unspecified unspecified  	O	null
8 as as as foreign unspecified unspecified unspecified unspecified unspecified  	O	null
9 Pseudonym Pseudonym Pseudonym foreign unspecified unspecified unspecified unspecified unspecified  	O	null
10 " " " punctuation unspecified unspecified unspecified unspecified unspecified  	O	null
11 . . . punctuation unspecified unspecified unspecified unspecified unspecified  	O	null

0 New New New foreign unspecified unspecified unspecified unspecified unspecified  	O	null
1 Literary Literary Literary foreign unspecified unspecified unspecified unspecified unspecified  	O	null
2 History History History foreign unspecified unspecified unspecified unspecified unspecified  	O	null
3 , , , punctuation unspecified unspecified unspecified unspecified unspecified  	O	null
4 ###NUMBER### ###NUMBER### ###NUMBER### numeral unspecified unspecified unspecified unspecified unspecified  	O	null
5 ###NUMBER### ###NUMBER### ###NUMBER### numeral unspecified unspecified unspecified unspecified unspecified  	O	null
6 . . . punctuation unspecified unspecified unspecified unspecified unspecified  	O	null

0 ###NUMBER### ###NUMBER### ###NUMBER### numeral unspecified unspecified unspecified unspecified unspecified  	I_DATE	null
1 . . . punctuation unspecified unspecified unspecified unspecified unspecified  	O	null

0 ###NUMBER### ###NUMBER### ###NUMBER### numeral unspecified unspecified unspecified unspecified unspecified  	O	null
1 - - - punctuation unspecified unspecified unspecified unspecified unspecified  	O	null
2 ###NUMBER### ###NUMBER### ###NUMBER### numeral unspecified unspecified unspecified unspecified unspecified  	O	null
3 . . . punctuation unspecified unspecified unspecified unspecified unspecified  	O	null

